index;label;degree_in;degree_out;degree_total;weight;compound_type;domain
1922;h;784;216;1000;1.007276452;ion;all
2601;h[p];18;175;193;1.007276452;ion;all
2812;h[e];0;3;3;1.007276452;ion;all
2678;h2;3;3;6;2.015650064;metabolite;all
3211;h2[e];0;1;1;2.015650064;metabolite;all
3212;h2[p];1;1;2;2.015650064;metabolite;all
1956;nh4;46;4;50;17.0265491;metabolite;all
2608;nh4[p];3;1;4;17.0265491;metabolite;all
3350;nh4[e];0;1;1;17.0265491;metabolite;all
1954;h2o;105;581;686;18.01056468;metabolite;all
2607;h2o[p];9;2;11;18.01056468;metabolite;all
3208;h2o[e];0;1;1;18.01056468;metabolite;all
714;s0001;0;29;29;18.0153;protein;all
1658;b2092;0;1;1;18.0153;protein;all
2791;na1[p];4;12;16;22.9892207;ion;all
2792;na1;12;3;15;22.9892207;ion;all
3349;na1[e];0;1;1;22.9892207;ion;all
3320;mg2[p];1;3;4;23.98394454;ion;all
3321;mg2;3;0;3;23.98394454;ion;all
3322;mg2[e];0;1;1;23.98394454;ion;all
312;magnesium;1;2;3;23.98394454;ion;all
2397;cyan;0;3;3;26.00362258;metabolite;all
2933;cyan[e];0;1;1;26.00362258;metabolite;all
2934;cyan[p];1;0;1;26.00362258;metabolite;all
2611;no;1;3;4;29.99798862;metabolite;all
3357;no[e];0;1;1;29.99798862;metabolite;all
3358;no[p];1;1;2;29.99798862;metabolite;all
2400;fald;4;1;5;30.01056468;metabolite;all
3045;fald[e];0;1;1;30.01056468;metabolite;all
3046;fald[p];1;1;2;30.01056468;metabolite;all
2346;s;0;1;1;31.972071;metabolite;all
2019;o2;4;39;43;31.98982924;metabolite;all
3373;o2[e];0;1;1;31.98982924;metabolite;all
3374;o2[p];1;1;2;31.98982924;metabolite;all
2681;o2s;2;2;4;31.99037782;metabolite;all
3371;o2s[e];0;1;1;31.99037782;metabolite;all
3372;o2s[p];1;0;1;31.99037782;metabolite;all
2192;ACP;40;11;51;32.97989603;metabolite;all
2416;h2s;3;3;6;33.98772106;metabolite;all
3209;h2s[p];2;0;2;33.98772106;metabolite;all
3210;h2s[e];0;1;1;33.98772106;metabolite;all
2161;h2o2;13;4;17;34.0054793;metabolite;all
3206;h2o2[e];0;1;1;34.0054793;metabolite;all
3207;h2o2[p];1;0;1;34.0054793;metabolite;all
2899;cl[p];1;1;2;34.96940126;metabolite;all
2900;cl;1;0;1;34.96940126;ion;all
2901;cl[e];0;1;1;34.96940126;ion;all
3250;k[p];2;2;4;38.9631581;ion;all
3251;k;2;1;3;38.9631581;ion;all
3252;k[e];0;1;1;38.9631581;ion;all
2869;ca2;0;2;2;39.96149382;ion;all
2870;ca2[p];3;0;3;39.96149382;ion;all
2871;ca2[e];0;1;1;39.96149382;ion;all
2610;cynt;1;1;2;43.00581365;metabolite;all
2936;cynt[p];1;1;2;43.00581365;metabolite;all
2937;cynt[e];0;1;1;43.00581365;metabolite;all
2016;co2;74;4;78;43.98982924;metabolite;all
2904;co2[e];0;1;1;43.98982924;metabolite;all
2905;co2[p];1;1;2;43.98982924;metabolite;all
2612;n2o;2;0;2;44.00106262;metabolite;all
3345;n2o[e];0;1;1;44.00106262;metabolite;all
3346;n2o[p];1;1;2;44.00106262;metabolite;all
2005;acald;8;3;11;44.02621475;metabolite;all
2764;acald[e];0;1;1;44.02621475;metabolite;all
2765;acald[p];1;1;2;44.02621475;metabolite;all
2012;for;12;3;15;46.0054793;metabolite;all
2794;for[p];2;3;5;46.0054793;metabolite;all
3085;for[e];0;1;1;46.0054793;metabolite;all
2856;etoh;1;1;2;46.04186481;metabolite;all
3033;etoh[p];1;1;2;46.04186481;metabolite;all
3034;etoh[e];0;1;1;46.04186481;metabolite;all
2606;no2[p];4;3;7;47.00072827;metabolite;all
2679;no2;3;2;5;47.00072827;metabolite;all
3355;no2[e];0;1;1;47.00072827;metabolite;all
311;manganese;1;1;2;54.9;ion;all
3333;mn2;2;1;3;54.93694794;ion;all
3334;mn2[p];2;2;4;54.93694794;ion;all
3337;mn2[e];0;1;1;54.93694794;ion;all
2043;fe3;5;7;12;55.93329176;ion;all
3053;fe3[p];1;1;2;55.93329176;ion;all
3065;fe3[e];0;1;1;55.93329176;ion;all
2042;fe2;22;4;26;55.93384034;ion;all
3051;fe2[p];2;3;5;55.93384034;ion;all
3052;fe2[e];0;1;1;55.93384034;ion;all
3351;ni2;2;2;4;57.93424574;ion;all
3352;ni2[p];3;2;5;57.93424574;ion;all
3353;ni2[e];0;1;1;57.93424574;ion;all
2184;ppal;0;2;2;58.04186481;metabolite;all
3421;ppal[e];0;1;1;58.04186481;metabolite;all
3422;ppal[p];2;0;2;58.04186481;metabolite;all
2906;cobalt2;1;2;3;58.93209784;metabolite;all
2907;cobalt2[p];3;1;4;58.93209784;ion;all
2908;cobalt2[e];0;1;1;58.93209784;ion;all
2399;tcynt;3;0;3;58.98297003;metabolite;all
3480;tcynt[e];0;1;1;58.98297003;metabolite;all
3481;tcynt[p];1;0;1;58.98297003;metabolite;all
2050;aacald;1;1;2;59.03711378;metabolite;all
2686;tma;2;0;2;59.07349929;metabolite;all
2778;tma[p];3;0;3;59.07349929;metabolite;all
3502;tma[e];0;1;1;59.07349929;metabolite;all
2026;ac;14;2;16;60.02112937;metabolite;all
2389;gcald;2;1;3;60.02112937;metabolite;all
2790;ac[p];1;2;3;60.02112937;metabolite;all
2793;ac[e];0;1;1;60.02112937;metabolite;all
2244;urea;2;0;2;60.03236275;metabolite;all
3541;urea[e];0;1;1;60.03236275;metabolite;all
3542;urea[p];1;1;2;60.03236275;metabolite;all
2216;hco3;1;4;5;60.99311747;metabolite;all
2539;etha;3;1;4;61.05276384;metabolite;all
3028;etha[p];1;1;2;61.05276384;metabolite;all
3029;etha[e];0;1;1;61.05276384;metabolite;all
2684;dms;2;0;2;62.01902119;metabolite;all
2776;dms[p];3;0;3;62.01902119;metabolite;all
2993;dms[e];0;1;1;62.01902119;metabolite;all
2929;cu2;2;1;3;62.9295975;ion;all
2930;cu2[p];2;1;3;62.9295975;ion;all
2931;cu2[e];0;1;1;62.9295975;ion;all
2613;no3;3;2;5;62.99564289;ion;all
2614;no3[p];1;3;4;62.99564289;ion;all
3356;no3[e];0;1;1;62.99564289;ion;all
3557;zn2;2;2;4;63.92804504;ion;all
3558;zn2[p];3;2;5;63.92804504;ion;all
3559;zn2[e];0;1;1;63.92804504;ion;all
2418;so2;2;0;2;63.96190024;ion;all
3460;so2[e];0;1;1;63.96190024;ion;all
3461;so2[p];1;1;2;63.96190024;ion;all
351;zinc;1;1;2;63.92804504;ion;all
2579;mthgxl;2;4;6;72.02112937;metabolite;all
2121;btal;1;1;2;72.05751488;metabolite;all
2578;aact;1;1;2;73.05276384;metabolite;all
2002;glx;6;4;10;74.00039392;metabolite;all
2146;lald-L;2;2;4;74.03677943;metabolite;all
2514;acetol;1;1;2;74.03677943;metabolite;all
2581;lald-D;1;1;2;74.03677943;metabolite;all
2200;acACP;2;1;3;74.99046072;metabolite;all
2255;gly;8;5;13;75.0320284;metabolite;all
3184;gly[p];1;2;3;75.0320284;metabolite;all
3185;gly[e];0;1;1;75.0320284;metabolite;all
2685;tmao;0;2;2;75.06841391;metabolite;all
2777;tmao[p];1;2;3;75.06841391;metabolite;all
3501;tmao[e];0;1;1;75.06841391;metabolite;all
2000;glyclt;6;3;9;76.01604399;metabolite;all
3174;glyclt[p];1;2;3;76.01604399;metabolite;all
3175;glyclt[e];0;1;1;76.01604399;metabolite;all
2171;12ppd-S;2;1;3;76.0524295;metabolite;all
2515;12ppd-R;3;1;4;76.0524295;metabolite;all
2700;12ppd-R[e];0;1;1;76.0524295;metabolite;all
2701;12ppd-R[p];1;1;2;76.0524295;metabolite;all
2702;12ppd-S[e];0;1;1;76.0524295;metabolite;all
2703;12ppd-S[p];1;1;2;76.0524295;metabolite;all
2683;dmso;0;2;2;78.01393581;metabolite;all
2775;dmso[p];1;2;3;78.01393581;metabolite;all
2992;dmso[e];0;1;1;78.01393581;metabolite;all
2994;seln;0;1;1;81.93217136;metabolite;all
2051;so3;10;1;11;81.97246492;ion;all
3462;so3[e];0;1;1;81.97246492;ion;all
3463;so3[p];1;0;1;81.97246492;ion;all
3427;ppt[e];0;1;1;81.98198059;metabolite;all
3428;ppt[p];1;0;1;81.98198059;metabolite;all
3441;ppt;0;1;1;81.98198059;metabolite;all
2225;4abutn;1;1;2;87.06841391;metabolite;all
1918;pyr;51;8;59;88.01604399;metabolite;all
3439;pyr[p];1;1;2;88.01604399;metabolite;all
3440;pyr[e];0;1;1;88.01604399;metabolite;all
2079;ptrc;5;3;8;88.10004838;metabolite;all
3437;ptrc[p];1;3;4;88.10004838;metabolite;all
3438;ptrc[e];0;1;1;88.10004838;metabolite;all
3007;oxam;1;1;2;89.01129296;metabolite;all
1917;ala-L;6;7;13;89.04767846;metabolite;all
1952;ala-D;18;3;21;89.04767846;metabolite;all
2340;ala-B;2;1;3;89.04767846;metabolite;all
2548;sarcs;0;1;1;89.04767846;metabolite;all
2818;ala-L[p];1;3;4;89.04767846;metabolite;all
2824;ala-L[e];0;1;1;89.04767846;metabolite;all
2862;ala-B[p];1;1;2;89.04767846;metabolite;all
2863;ala-B[e];0;1;1;89.04767846;metabolite;all
2948;ala-D[p];1;1;2;89.04767846;metabolite;all
2949;ala-D[e];0;1;1;89.04767846;metabolite;all
2040;lac-D;4;2;6;90.03169405;metabolite;all
2127;dha;3;1;4;90.03169405;metabolite;all
2165;glyald;1;1;2;90.03169405;metabolite;all
2175;lac-L;2;2;4;90.03169405;metabolite;all
2971;dha[e];0;1;1;90.03169405;metabolite;all
2972;dha[p];1;1;2;90.03169405;metabolite;all
2988;lac-D[p];1;1;2;90.03169405;metabolite;all
2989;lac-D[e];0;1;1;90.03169405;metabolite;all
3162;glyald[e];0;1;1;90.03169405;metabolite;all
3163;glyald[p];1;1;2;90.03169405;metabolite;all
3263;lac-L[p];1;1;2;90.03169405;metabolite;all
3264;lac-L[e];0;1;1;90.03169405;metabolite;all
2081;glyc;12;3;15;92.04734412;metabolite;all
3176;glyc[e];0;1;1;92.04734412;metabolite;all
3177;glyc[p];2;0;2;92.04734412;metabolite;all
3049;mso3;1;1;2;95.98811499;metabolite;all
3343;mso3[p];1;1;2;95.98811499;metabolite;all
3344;mso3[e];0;1;1;95.98811499;metabolite;all
2422;so4;2;1;3;97.96737954;ion;all
3464;so4[e];0;1;1;97.96737954;ion;all
3465;so4[p];1;1;2;97.96737954;ion;all
68;pi;773;28;801;97.97689521;ion;all
3040;pi[p];6;2;8;97.97689521;ion;all
3418;pi[e];0;1;1;97.97689521;ion;all
2107;but2eACP;1;2;3;101.0061108;metabolite;all
2011;2obut;1;2;3;102.0316941;metabolite;all
2025;acac;1;1;2;102.0316941;metabolite;all
2224;sucsal;1;2;3;102.0316941;metabolite;all
2762;acac[p];1;1;2;102.0316941;metabolite;all
2763;acac[e];0;1;1;102.0316941;metabolite;all
2995;betald;0;2;2;102.0913404;metabolite;all
2872;15dap;1;1;2;102.1156984;metabolite;all
2874;15dap[p];2;0;2;102.1156984;metabolite;all
2952;15dap[e];0;1;1;102.1156984;metabolite;all
2551;2amsa;2;0;2;103.026943;metabolite;all
2159;4abut;4;2;6;103.0633285;metabolite;all
2760;4abut[p];2;1;3;103.0633285;metabolite;all
2761;4abut[e];0;1;1;103.0633285;metabolite;all
1943;3haACP;1;1;2;103.9932004;metabolite;all
2006;2h3oppan;3;1;4;104.0109586;metabolite;all
2170;hpyr;0;3;3;104.0109586;metabolite;all
1965;23dappa;1;1;2;104.0585775;metabolite;all
2714;23dappa[p];1;1;2;104.0585775;metabolite;all
2715;23dappa[e];0;1;1;104.0585775;metabolite;all
2538;chol;4;0;4;104.1069905;metabolite;all
2886;chol[p];1;2;3;104.1069905;metabolite;all
2887;chol[e];0;1;1;104.1069905;metabolite;all
2279;ser-L;7;16;23;105.0425931;metabolite;all
2550;ser-D;1;2;3;105.0425931;metabolite;all
3001;ser-D[p];1;1;2;105.0425931;metabolite;all
3002;ser-D[e];0;1;1;105.0425931;metabolite;all
3453;ser-L[p];1;2;3;105.0425931;metabolite;all
3454;ser-L[e];0;1;1;105.0425931;metabolite;all
2007;glyc-R;5;2;7;106.0266087;metabolite;all
3170;glyc-R[p];1;1;2;106.0266087;metabolite;all
3171;glyc-R[e];0;1;1;106.0266087;metabolite;all
2811;ag;0;1;1;106.905097;metabolite;all
2813;ag[e];1;0;1;106.905097;metabolite;all
2065;hqn;1;0;1;110.0367794;metabolite;all
2126;csn;3;1;4;111.0432618;metabolite;all
2924;csn[p];1;1;2;111.0432618;metabolite;all
2925;csn[e];0;1;1;111.0432618;metabolite;all
2188;ura;6;1;7;112.0272774;metabolite;all
3539;ura[p];1;2;3;112.0272774;metabolite;all
3540;ura[e];0;1;1;112.0272774;metabolite;all
2398;tsul;1;2;3;112.9372595;metabolite;all
3507;tsul[p];1;1;2;112.9372595;metabolite;all
3508;tsul[e];0;1;1;112.9372595;metabolite;all
2220;1pyr5c;2;2;4;113.0476785;metabolite;all
2879;cd2;1;2;3;113.9033585;ion;all
2880;cd2[p];3;1;4;113.9033585;ion;all
2881;cd2[e];0;1;1;113.9033585;ion;all
2221;pro-L;5;2;7;115.0633285;metabolite;all
3429;pro-L[p];1;3;4;115.0633285;metabolite;all
3432;pro-L[e];0;1;1;115.0633285;metabolite;all
1962;fum;9;5;14;116.0109586;metabolite;all
3097;fum[p];1;3;4;116.0109586;metabolite;all
3098;fum[e];0;1;1;116.0109586;metabolite;all
1916;3mob;2;3;5;116.0473441;metabolite;all
2031;hxa;2;1;3;116.0837296;metabolite;all
2676;hxa[p];1;2;3;116.0837296;metabolite;all
3231;hxa[e];0;1;1;116.0837296;metabolite;all
1942;actACP;2;1;3;117.0010254;metabolite;all
2546;2aobut;3;1;4;117.0425931;metabolite;all
2889;aspsa;1;2;3;117.0425931;metabolite;all
2975;indole;3;2;5;117.0578492;metabolite;all
3240;indole[p];2;1;3;117.0578492;metabolite;all
3241;indole[e];0;1;1;117.0578492;metabolite;all
1919;val-L;3;2;5;117.0789786;metabolite;all
2996;glyb;4;0;4;117.0789786;metabolite;all
3164;glyb[p];1;2;3;117.0789786;metabolite;all
3165;glyb[e];0;1;1;117.0789786;metabolite;all
3545;val-L[p];1;2;3;117.0789786;metabolite;all
3546;val-L[e];0;1;1;117.0789786;metabolite;all
2052;succ;15;7;22;118.0266087;metabolite;all
2891;succ[p];5;2;7;118.0266087;metabolite;all
3471;succ[e];0;1;1;118.0266087;metabolite;all
2549;thr-L;5;5;10;119.0582431;metabolite;all
2577;hom-L;0;4;4;119.0582431;metabolite;all
2895;athr-L;0;2;2;119.0582431;metabolite;all
3227;hom-L[p];2;0;2;119.0582431;metabolite;all
3228;hom-L[e];0;1;1;119.0582431;metabolite;all
3492;thr-L[p];2;3;5;119.0582431;metabolite;all
3495;thr-L[e];0;1;1;119.0582431;metabolite;all
2424;mercppyr;0;1;1;119.988115;metabolite;all
2183;pacald;2;1;3;120.0575149;metabolite;all
3388;pacald[p];1;1;2;120.0575149;metabolite;all
3389;pacald[e];0;1;1;120.0575149;metabolite;all
2318;cys-L;3;8;11;121.0197495;metabolite;all
2425;cys-D;1;1;2;121.0197495;metabolite;all
2938;cys-L[p];3;1;4;121.0197495;metabolite;all
2939;cys-D[p];1;1;2;121.0197495;metabolite;all
2940;cys-D[e];0;1;1;121.0197495;metabolite;all
2941;cys-L[e];0;1;1;121.0197495;metabolite;all
3328;peamn;0;1;1;121.0891494;metabolite;all
3397;peamn[e];0;1;1;121.0891494;metabolite;all
3398;peamn[p];1;0;1;121.0891494;metabolite;all
2413;ncam;3;1;4;122.0480128;metabolite;all
2852;aso3;1;1;2;122.9079861;metabolite;all
2853;aso3[p];2;0;2;122.9079861;metabolite;all
2854;aso3[e];0;1;1;122.9079861;metabolite;all
2371;nac;3;1;4;123.0320284;metabolite;all
3347;nac[e];0;1;1;123.0320284;metabolite;all
3348;nac[p];1;1;2;123.0320284;metabolite;all
2356;4hba;1;1;2;124.0524295;metabolite;all
2049;taur;1;1;2;125.0146641;metabolite;all
3478;taur[p];1;1;2;125.0146641;metabolite;all
3479;taur[e];0;1;1;125.0146641;metabolite;all
3048;isetac;1;1;2;125.9986797;metabolite;all
3246;isetac[p];1;1;2;125.9986797;metabolite;all
3247;isetac[e];0;1;1;125.9986797;metabolite;all
2667;thym;1;1;2;126.0429274;metabolite;all
3496;thym[p];2;0;2;126.0429274;metabolite;all
3497;thym[e];0;1;1;126.0429274;metabolite;all
2109;thex2eACP;1;2;3;129.0374109;metabolite;all
3467;3mop;2;0;2;130.0629942;metabolite;all
3500;4mop;1;1;2;130.0629942;metabolite;all
2243;agm;2;2;4;130.1218464;metabolite;all
2809;agm[e];0;1;1;130.1218464;metabolite;all
2810;agm[p];2;0;2;130.1218464;metabolite;all
2350;iasp;4;1;5;131.0218576;metabolite;all
2239;glu5sa;2;1;3;131.0582431;metabolite;all
2262;5aop;1;1;2;131.0582431;metabolite;all
2408;glu1sa;1;1;2;131.0582431;metabolite;all
2919;ile-L;2;2;4;131.0946287;metabolite;all
2921;leu-L;3;1;4;131.0946287;metabolite;all
3236;ile-L[p];1;2;3;131.0946287;metabolite;all
3237;ile-L[e];0;1;1;131.0946287;metabolite;all
3257;leu-L[p];1;2;3;131.0946287;metabolite;all
3258;leu-L[e];0;1;1;131.0946287;metabolite;all
1949;oaa;7;4;11;132.0058732;metabolite;all
2204;oxur;1;1;2;132.0171066;metabolite;all
2023;4h2opntn;1;1;2;132.0422587;metabolite;all
2572;dhptd;1;1;2;132.0422587;metabolite;all
3457;alac-S;2;0;2;132.0422587;metabolite;all
1959;asn-L;4;3;7;132.0534921;metabolite;all
2850;asn-L[p];1;2;3;132.0534921;metabolite;all
2851;asn-L[e];0;1;1;132.0534921;metabolite;all
2242;orn;2;4;6;132.0898776;metabolite;all
2846;orn[p];3;1;4;132.0898776;metabolite;all
3378;orn[e];0;1;1;132.0898776;metabolite;all
1948;asp-L;6;15;21;133.0375077;metabolite;all
2855;asp-L[p];1;4;5;133.0375077;metabolite;all
2857;asp-L[e];0;1;1;133.0375077;metabolite;all
2190;mal-D;1;1;2;134.0215233;metabolite;all
2213;mal-L;4;5;9;134.0215233;metabolite;all
3277;mal-D[p];1;1;2;134.0215233;metabolite;all
3278;mal-D[e];0;1;1;134.0215233;metabolite;all
3279;mal-L[p];1;2;3;134.0215233;metabolite;all
3281;mal-L[e];0;1;1;134.0215233;metabolite;all
2057;urdglyc;1;2;3;134.0327567;metabolite;all
2362;dxyl;0;1;1;134.0579088;metabolite;all
3456;23dhmb;0;2;2;134.0579088;metabolite;all
2568;hcys-L;2;3;5;135.0353995;metabolite;all
2414;4hthr;1;0;1;135.0531578;metabolite;all
2045;ade;9;2;11;135.0544952;metabolite;all
2795;ade[p];1;1;2;135.0544952;metabolite;all
2796;ade[e];0;1;1;135.0544952;metabolite;all
2615;hxan;5;2;7;136.0385107;metabolite;all
3232;hxan[e];0;1;1;136.0385107;metabolite;all
3233;hxan[p];1;1;2;136.0385107;metabolite;all
2067;pac;1;1;2;136.0524295;metabolite;all
2752;4hoxpacd[e];0;1;1;136.0524295;metabolite;all
2753;4hoxpacd[p];1;0;1;136.0524295;metabolite;all
3330;4hoxpacd;1;0;1;136.0524295;metabolite;all
2307;4abz;1;1;2;137.0476785;metabolite;all
2977;anth;1;2;3;137.0476785;metabolite;all
3329;tym;0;1;1;137.084064;metabolite;all
3514;tym[e];0;1;1;137.084064;metabolite;all
3515;tym[p];1;0;1;137.084064;metabolite;all
2312;4hbz;1;1;2;138.0316941;metabolite;all
2311;4ahmmp;0;1;1;139.0745619;metabolite;all
3050;sulfac;1;1;2;139.9779442;metabolite;all
3474;sulfac[p];1;1;2;139.9779442;metabolite;all
3475;sulfac[e];0;1;1;139.9779442;metabolite;all
2836;actp;2;0;2;139.9874599;metabolite;all
2217;cbp;3;2;5;140.9827089;metabolite;all
2564;histd;1;1;2;141.090212;metabolite;all
2858;aso4;0;1;1;141.9247301;metabolite;all
2314;4mhetz;0;1;1;143.0404849;metabolite;all
2691;ctbt;3;1;4;143.0946287;metabolite;all
2926;ctbt[p];0;2;2;143.0946287;metabolite;all
2470;octa;2;1;3;144.1150298;metabolite;all
2677;octa[p];1;1;2;144.1150298;metabolite;all
3377;octa[e];0;1;1;144.1150298;metabolite;all
1944;3ohexACP;1;1;2;145.0323255;metabolite;all
2235;spmd;3;3;6;145.1578976;metabolite;all
3468;spmd[p];1;1;2;145.1578976;metabolite;all
3469;spmd[e];0;1;1;145.1578976;metabolite;all
1920;akg;10;15;25;146.0215233;metabolite;all
2816;akg[p];1;1;2;146.0215233;metabolite;all
2817;akg[e];0;1;1;146.0215233;metabolite;all
2282;2dhp;1;1;2;146.0579088;metabolite;all
3470;2ahbut;1;1;2;146.0579088;metabolite;all
1960;gln-L;2;14;16;146.0691422;metabolite;all
3158;gln-L[p];1;1;2;146.0691422;metabolite;all
3159;gln-L[e];0;1;1;146.0691422;metabolite;all
2390;dmbzid;0;1;1;146.0843983;metabolite;all
2147;lys-L;5;3;8;146.1055277;metabolite;all
2873;lys-L[p];2;3;5;146.1055277;metabolite;all
3273;lys-L[e];0;1;1;146.1055277;metabolite;all
2740;gbbtn;1;1;2;146.1175552;metabolite;all
2922;gbbtn[p];2;0;2;146.1175552;metabolite;all
3140;gbbtn[e];0;1;1;146.1175552;metabolite;all
1945;3hhexACP;1;1;2;147.0479756;metabolite;all
475;glu-L;34;17;51;147.0531578;metabolite;all
2419;acser;1;2;3;147.0531578;metabolite;all
2646;glu-D;0;2;2;147.0531578;metabolite;all
2788;acser[e];0;1;1;147.0531578;metabolite;all
2789;acser[p];2;0;2;147.0531578;metabolite;all
3160;glu-L[p];1;4;5;147.0531578;metabolite;all
3161;glu-L[e];0;1;1;147.0531578;metabolite;all
2222;2kmb;2;1;3;148.0194151;metabolite;all
2124;cinnm;0;1;1;148.0524295;metabolite;all
2283;pant-R;1;1;2;148.0735589;metabolite;all
3466;23dhmp;1;1;2;148.0735589;metabolite;all
2223;met-L;9;4;13;149.0510496;metabolite;all
3309;met-L[p];1;1;2;149.0510496;metabolite;all
3310;met-D[p];1;1;2;149.0510496;metabolite;all
3311;met-D;1;0;1;149.0510496;metabolite;all
3312;met-D[e];0;1;1;149.0510496;metabolite;all
3319;met-L[e];0;1;1;149.0510496;metabolite;all
2210;tartr-L;1;1;2;150.0164379;metabolite;all
3476;tartr-L[p];1;1;2;150.0164379;metabolite;all
3477;tartr-L[e];0;1;1;150.0164379;metabolite;all
2046;rib-D;8;1;9;150.0528234;metabolite;all
2061;arab-L;2;2;4;150.0528234;metabolite;all
2062;rbl-L;1;1;2;150.0528234;metabolite;all
2118;xylu-D;1;1;2;150.0528234;metabolite;all
2120;xylu-L;2;1;3;150.0528234;metabolite;all
2189;lyx-L;1;1;2;150.0528234;metabolite;all
2212;xyl-D;2;1;3;150.0528234;metabolite;all
2837;arab-L[p];2;2;4;150.0528234;metabolite;all
2838;arab-L[e];0;1;1;150.0528234;metabolite;all
3275;lyx-L[p];1;1;2;150.0528234;metabolite;all
3276;lyx-L[e];0;1;1;150.0528234;metabolite;all
3446;rib-D[p];1;1;2;150.0528234;metabolite;all
3447;rib-D[e];0;1;1;150.0528234;metabolite;all
3553;xyl-D[p];1;2;3;150.0528234;metabolite;all
3554;xyl-D[e];0;1;1;150.0528234;metabolite;all
3555;xylu-L[p];1;1;2;150.0528234;metabolite;all
3556;xylu-L[e];0;1;1;150.0528234;metabolite;all
2173;pppn;1;1;2;150.0680796;metabolite;all
3425;pppn[p];1;1;2;150.0680796;metabolite;all
3426;pppn[e];0;1;1;150.0680796;metabolite;all
2653;gua;4;2;6;151.0494098;metabolite;all
3202;gua[p];1;2;3;151.0494098;metabolite;all
3203;gua[e];0;1;1;151.0494098;metabolite;all
2662;xan;6;2;8;152.0334254;metabolite;all
3547;xan[p];1;2;3;152.0334254;metabolite;all
3548;xan[e];0;1;1;152.0334254;metabolite;all
2741;34dhpac[e];0;1;1;152.0473441;metabolite;all
2742;34dhpac[p];1;0;1;152.0473441;metabolite;all
3266;34dhpac;1;0;1;152.0473441;metabolite;all
2417;3sala;0;1;1;153.0095787;metabolite;all
2997;dopa[e];0;1;1;153.0789786;metabolite;all
2998;dopa[p];1;0;1;153.0789786;metabolite;all
3265;dopa;0;1;1;153.0789786;metabolite;all
2047;ppap;1;1;2;154.00311;metabolite;all
2277;23dhb;2;1;3;154.0266087;metabolite;all
2565;his-L;3;1;4;155.0694765;metabolite;all
3225;his-L[p];1;2;3;155.0694765;metabolite;all
3226;his-L[e];0;1;1;155.0694765;metabolite;all
2014;2pglyc;0;1;1;155.9823745;metabolite;all
2831;orot;4;0;4;156.0171066;metabolite;all
3379;orot[p];1;1;2;156.0171066;metabolite;all
3380;orot[e];0;1;1;156.0171066;metabolite;all
2276;23ddhb;1;1;2;156.0422587;metabolite;all
2111;toct2eACP;1;2;3;157.068711;metabolite;all
2830;dhor-S;0;3;3;158.0327567;metabolite;all
2609;alltn;2;1;3;158.0439901;metabolite;all
2827;alltn[p];1;1;2;158.0439901;metabolite;all
2828;alltn[e];0;1;1;158.0439901;metabolite;all
3486;2ippm;1;1;2;158.0579088;metabolite;all
2586;alaala;6;2;8;160.0847922;metabolite;all
2819;alaala[p];1;1;2;160.0847922;metabolite;all
2820;alaala[e];0;1;1;160.0847922;metabolite;all
2687;crn;4;3;7;161.1051933;metabolite;all
2689;crn-D;2;2;4;161.1051933;metabolite;all
2918;crn[p];1;4;5;161.1051933;metabolite;all
2920;crn-D[p];1;2;3;161.1051933;metabolite;all
2923;crn[e];0;1;1;161.1051933;metabolite;all
2953;selnp;1;1;2;161.8985019;metabolite;all
3340;mobd[p];1;1;2;163.9007167;metabolite;all
3341;mobd;1;0;1;163.9007167;metabolite;all
3342;mobd[e];0;1;1;163.9007167;metabolite;all
2018;3hcinnm;1;1;2;164.0473441;metabolite;all
2979;phpyr;2;0;2;164.0473441;metabolite;all
3213;3hcinnm[p];1;1;2;164.0473441;metabolite;all
3214;3hcinnm[e];0;1;1;164.0473441;metabolite;all
2071;fcl-L;1;1;2;164.0684735;metabolite;all
2114;rml;1;1;2;164.0684735;metabolite;all
2207;rmn;1;1;2;164.0684735;metabolite;all
3448;rmn[e];0;1;1;164.0684735;metabolite;all
3449;rmn[p];1;1;2;164.0684735;metabolite;all
2576;mmet;1;1;2;164.0739761;metabolite;all
3331;mmet[p];1;1;2;164.0739761;metabolite;all
3332;mmet[e];0;1;1;164.0739761;metabolite;all
2574;metsox-R-L;2;1;3;165.0459642;metabolite;all
2575;metsox-S-L;2;1;3;165.0459642;metabolite;all
3315;metsox-S-L[p];1;1;2;165.0459642;metabolite;all
3316;metsox-S-L[e];0;1;1;165.0459642;metabolite;all
3317;metsox-R-L[p];1;1;2;165.0459642;metabolite;all
3318;metsox-R-L[e];0;1;1;165.0459642;metabolite;all
2935;phe-L;1;2;3;165.0789786;metabolite;all
3416;phe-L[p];1;1;2;165.0789786;metabolite;all
3417;phe-L[e];0;1;1;165.0789786;metabolite;all
2021;3hpppn;1;1;2;166.0629942;metabolite;all
3229;3hpppn[p];1;1;2;166.0629942;metabolite;all
3230;3hpppn[e];0;1;1;166.0629942;metabolite;all
2271;quln;1;1;2;167.0218576;metabolite;all
2375;pydx;1;1;2;167.0582431;metabolite;all
2128;pep;3;23;26;167.9823745;metabolite;all
2663;urate;1;1;2;168.02834;metabolite;all
2374;pydam;1;1;2;168.0898776;metabolite;all
2859;23dhdp;1;1;2;169.0375077;metabolite;all
2376;pydxn;1;1;2;169.0738932;metabolite;all
1995;g3p;11;3;14;169.9980246;metabolite;all
2129;dhap;9;3;12;169.9980246;metabolite;all
2860;thdp;1;1;2;171.0531578;metabolite;all
2082;glyc3p;27;19;46;172.0136746;metabolite;all
3166;glyc2p[e];0;1;1;172.0136746;metabolite;all
3167;glyc2p[p];1;0;1;172.0136746;metabolite;all
3168;glyc3p[p];1;2;3;172.0136746;metabolite;all
3169;glyc3p[e];0;1;1;172.0136746;metabolite;all
3274;glyc2p;0;1;1;172.0136746;metabolite;all
2973;3dhsk;1;1;2;172.0371734;metabolite;all
1946;3ooctACP;1;1;2;173.0636257;metabolite;all
2238;acg5sa;1;2;3;173.0688078;metabolite;all
2257;acon-C;2;1;3;174.0164379;metabolite;all
2990;acon-T;0;2;2;174.0164379;metabolite;all
2974;skm;2;1;3;174.0528234;metabolite;all
3458;skm[p];1;1;2;174.0528234;metabolite;all
3459;skm[e];0;1;1;174.0528234;metabolite;all
3499;3c4mop;1;1;2;174.0528234;metabolite;all
2241;acorn;0;2;2;174.1004423;metabolite;all
2247;arg-L;4;5;9;174.1116757;metabolite;all
2845;arg-L[p];2;3;5;174.1116757;metabolite;all
2847;arg-L[e];0;1;1;174.1116757;metabolite;all
1947;3hoctACP;1;1;2;175.0792757;metabolite;all
2249;citr-L;1;1;2;175.0956913;metabolite;all
2848;ascb-L[p];1;1;2;176.032088;metabolite;all
2849;ascb-L[e];0;1;1;176.032088;metabolite;all
2821;cbasp;2;0;2;176.0433214;metabolite;all
2056;alltt;1;1;2;176.0545547;metabolite;all
3487;3c3hmp;2;0;2;176.0684735;metabolite;all
3498;3c2hmp;0;2;2;176.0684735;metabolite;all
1961;ppi;126;3;129;177.9432257;metabolite;all
2423;cgly;2;1;3;178.0412132;metabolite;all
2884;cgly[p];1;1;2;178.0412132;metabolite;all
2885;cgly[e];0;1;1;178.0412132;metabolite;all
1975;2ddglcn;3;1;4;178.047738;metabolite;all
1977;2dh3dgal;1;1;2;178.047738;metabolite;all
2961;2ddglcn[p];1;1;2;178.047738;metabolite;all
2962;2ddglcn[e];0;1;1;178.047738;metabolite;all
2978;acanth;1;0;1;179.0582431;metabolite;all
3137;gam[p];1;1;2;179.0793725;metabolite;all
3138;gam[e];0;1;1;179.0793725;metabolite;all
2020;dhcinnm;2;1;3;180.0422587;metabolite;all
2980;34hpp;2;0;2;180.0422587;metabolite;all
2233;5mtr;1;1;2;180.0456299;metabolite;all
2029;glc-D;19;3;22;180.0633881;metabolite;all
2055;all-D;1;1;2;180.0633881;metabolite;all
2073;fru;3;1;4;180.0633881;metabolite;all
2076;gal;7;1;8;180.0633881;metabolite;all
2083;man;2;1;3;180.0633881;metabolite;all
2485;inost;5;0;5;180.0633881;metabolite;all
2797;glc-D[p];2;4;6;180.0633881;metabolite;all
2825;all-D[p];1;1;2;180.0633881;metabolite;all
2826;all-D[e];0;1;1;180.0633881;metabolite;all
3091;fru[p];1;2;3;180.0633881;metabolite;all
3092;fru[e];0;1;1;180.0633881;metabolite;all
3118;gal[p];1;2;3;180.0633881;metabolite;all
3119;gal-bD[e];0;1;1;180.0633881;metabolite;all
3120;gal-bD[p];1;0;1;180.0633881;metabolite;all
3130;gal[e];0;1;1;180.0633881;metabolite;all
3150;glc-D[e];0;2;2;180.0633881;metabolite;all
3242;inost[p];1;1;2;180.0633881;metabolite;all
3245;inost[e];0;1;1;180.0633881;metabolite;all
3271;gal-bD;0;1;1;180.0633881;metabolite;all
3296;man[p];1;1;2;180.0633881;metabolite;all
3297;man[e];0;1;1;180.0633881;metabolite;all
2355;tyr-L;2;3;5;181.0738932;metabolite;all
3518;tyr-L[p];1;1;2;181.0738932;metabolite;all
3519;tyr-L[e];0;1;1;181.0738932;metabolite;all
2022;dhpppn;2;1;3;182.0579088;metabolite;all
2123;cenchddd;1;1;2;182.0579088;metabolite;all
3131;galt[p];1;1;2;182.0790382;metabolite;all
3132;galt[e];0;1;1;182.0790382;metabolite;all
3335;mnl[p];1;1;2;182.0790382;metabolite;all
3336;mnl[e];0;1;1;182.0790382;metabolite;all
3451;sbt-D[p];1;1;2;182.0790382;metabolite;all
3452;sbt-D[e];0;1;1;182.0790382;metabolite;all
2544;3php;1;1;2;183.9772891;metabolite;all
2321;db4p;1;1;2;184.0136746;metabolite;all
2545;pser-L;1;2;3;185.0089236;metabolite;all
3435;pser-L[e];0;1;1;185.0089236;metabolite;all
3436;pser-L[p];1;0;1;185.0089236;metabolite;all
2089;tdec2eACP;1;3;4;185.1000112;metabolite;all
2543;3pg;2;2;4;185.9929392;metabolite;all
2547;2pg;1;2;3;185.9929392;metabolite;all
2326;8aonn;1;1;2;187.1208434;metabolite;all
2236;n8aspmd;1;0;1;187.1684623;metabolite;all
2237;N1aspmd;1;0;1;187.1684623;metabolite;all
2008;2mcacn;1;1;2;188.032088;metabolite;all
2991;aconm;1;0;1;188.032088;metabolite;all
2328;dann;1;1;2;188.1524779;metabolite;all
2234;acglu;1;1;2;189.0637225;metabolite;all
2970;3dhq;1;1;2;190.047738;metabolite;all
2599;26dap-M;3;2;5;190.0953569;metabolite;all
2716;26dap-M[e];0;1;1;190.0953569;metabolite;all
2717;26dap-M[p];1;1;2;190.0953569;metabolite;all
2861;26dap-LL;1;1;2;190.0953569;metabolite;all
1966;23doguln;0;1;1;192.0270026;metabolite;all
1972;25dkglcn;0;3;3;192.0270026;metabolite;all
2024;5dh4dglc;2;1;3;192.0270026;metabolite;all
2215;icit;1;2;3;192.0270026;metabolite;all
2256;cit;3;2;5;192.0270026;metabolite;all
2890;cit[p];1;1;2;192.0270026;metabolite;all
2892;cit[e];0;1;1;192.0270026;metabolite;all
1968;3dhguln;1;1;2;194.0426527;metabolite;all
1973;5dglcn;3;3;6;194.0426527;metabolite;all
1996;2dhglcn;0;2;2;194.0426527;metabolite;all
2060;tagur;3;0;3;194.0426527;metabolite;all
2157;galur;1;1;2;194.0426527;metabolite;all
2163;glcur;2;1;3;194.0426527;metabolite;all
2164;fruur;3;0;3;194.0426527;metabolite;all
2755;5dglcn[p];1;1;2;194.0426527;metabolite;all
2756;5dglcn[e];0;1;1;194.0426527;metabolite;all
3093;fruur[p];1;1;2;194.0426527;metabolite;all
3094;fruur[e];0;1;1;194.0426527;metabolite;all
3133;galur[p];1;1;2;194.0426527;metabolite;all
3134;galur[e];0;1;1;194.0426527;metabolite;all
3156;glcur[p];1;1;2;194.0426527;metabolite;all
3157;glcur[e];0;1;1;194.0426527;metabolite;all
2325;6hmhpt;1;1;2;195.0756245;metabolite;all
1997;glcn;4;1;5;196.0583027;metabolite;all
1998;idon-L;5;0;5;196.0583027;metabolite;all
2059;altrn;0;2;2;196.0583027;metabolite;all
2154;galctn-D;1;1;2;196.0583027;metabolite;all
2155;galctn-L;1;1;2;196.0583027;metabolite;all
2195;mana;0;2;2;196.0583027;metabolite;all
2798;glcn[p];2;1;3;196.0583027;metabolite;all
3122;galctn-L[p];1;1;2;196.0583027;metabolite;all
3123;galctn-L[e];0;1;1;196.0583027;metabolite;all
3124;galctn-D[p];1;1;2;196.0583027;metabolite;all
3125;galctn-D[e];0;1;1;196.0583027;metabolite;all
3147;glcn[e];0;1;1;196.0583027;metabolite;all
3234;idon-L[p];1;1;2;196.0583027;metabolite;all
3235;idon-L[e];0;1;1;196.0583027;metabolite;all
2896;phom;1;1;2;199.0245737;metabolite;all
3442;thrp;0;1;1;199.0245737;metabolite;all
3493;thrp[e];0;1;1;199.0245737;metabolite;all
3494;thrp[p];1;0;1;199.0245737;metabolite;all
2396;e4p;1;3;4;200.0085893;metabolite;all
1921;3odecACP;1;1;2;201.0949258;metabolite;all
3222;hg2;0;2;2;201.9695458;metabolite;all
3223;hg2[p];3;0;3;201.9695458;metabolite;all
3224;hg2[e];0;1;1;201.9695458;metabolite;all
1924;3hdecACP;1;1;2;203.1105758;metabolite;all
2387;dhna;1;1;2;204.0422587;metabolite;all
2553;trp-L;4;2;6;204.0898776;metabolite;all
3505;trp-L[p];1;1;2;204.0898776;metabolite;all
3506;trp-L[e];0;1;1;204.0898776;metabolite;all
2009;micit;1;1;2;206.0426527;metabolite;all
2010;2mcit;1;1;2;206.0426527;metabolite;all
2153;galct-D;1;1;2;210.0375673;metabolite;all
2162;glcr;1;1;2;210.0375673;metabolite;all
3126;galct-D[p];1;1;2;210.0375673;metabolite;all
3127;galct-D[e];0;1;1;210.0375673;metabolite;all
3148;glcr[p];1;1;2;210.0375673;metabolite;all
3149;glcr[e];0;1;1;210.0375673;metabolite;all
2144;hkntd;1;1;2;212.032088;metabolite;all
2888;4pasp;2;0;2;213.0038382;metabolite;all
2091;tddec2eACP;1;2;3;213.1313113;metabolite;all
2316;ohpb;1;1;2;213.9878538;metabolite;all
2003;2dr1p;5;1;6;214.0242393;metabolite;all
2004;2dr5p;1;1;2;214.0242393;metabolite;all
2354;dxyl5p;2;3;5;214.0242393;metabolite;all
2145;hkndd;1;1;2;214.047738;metabolite;all
2345;dtbt;1;1;2;214.1317424;metabolite;all
2395;phthr;1;2;3;215.0194883;metabolite;all
2471;g3pe;22;2;24;215.0558738;metabolite;all
3104;g3pe[p];1;1;2;215.0558738;metabolite;all
3105;g3pe[e];0;1;1;215.0558738;metabolite;all
2315;4per;1;1;2;216.0035039;metabolite;all
2288;2me4p;1;1;2;216.0398894;metabolite;all
2160;ggbutal;1;1;2;216.111007;metabolite;all
2597;LalaDglu;1;1;2;218.0902715;metabolite;all
2598;LalaLglu;1;1;2;218.0902715;metabolite;all
2552;Nmtrp;0;1;1;218.1055277;metabolite;all
2570;suchms;1;1;2;219.0742871;metabolite;all
2341;pnto-R;2;1;3;219.1106726;metabolite;all
3419;pnto-R[p];1;1;2;219.1106726;metabolite;all
3420;pnto-R[e];0;1;1;219.1106726;metabolite;all
2560;imacp;1;1;2;220.024908;metabolite;all
2563;hisp;1;1;2;221.0565425;metabolite;all
2037;acmana;1;1;2;221.0899372;metabolite;all
2585;acgam;4;1;5;221.0899372;metabolite;all
2768;acgal[e];0;1;1;221.0899372;metabolite;all
2769;acgal[p];1;0;1;221.0899372;metabolite;all
2773;acgam[p];1;1;2;221.0899372;metabolite;all
2774;acgam[e];0;1;1;221.0899372;metabolite;all
2780;acmana[p];1;1;2;221.0899372;metabolite;all
2781;acmana[e];0;1;1;221.0899372;metabolite;all
3199;acgal;1;0;1;221.0899372;metabolite;all
2303;sucbz;1;1;2;222.0528234;metabolite;all
2571;cyst-L;1;1;2;222.0674279;metabolite;all
2030;acglc-D;1;0;1;222.0739528;metabolite;all
2285;4mpetz;2;1;3;223.0068154;metabolite;all
2310;4adcho;1;1;2;225.0637225;metabolite;all
2384;chor;1;6;7;226.047738;metabolite;all
2385;ichor;2;2;4;226.047738;metabolite;all
2987;pphn;1;2;3;226.047738;metabolite;all
2263;ppbng;1;1;2;226.0953569;metabolite;all
2250;glu5p;1;1;2;227.0194883;metabolite;all
2651;dcyt;3;1;4;227.0906059;metabolite;all
2958;dcyt[p];1;1;2;227.0906059;metabolite;all
2959;dcyt[e];0;1;1;227.0906059;metabolite;all
2637;duri;4;2;6;228.0746215;metabolite;all
3008;duri[p];1;1;2;228.0746215;metabolite;all
3009;duri[e];0;1;1;228.0746215;metabolite;all
2829;pram;1;1;2;229.0351384;metabolite;all
1926;3oddecACP;1;1;2;229.1262259;metabolite;all
2017;xu5p-L;2;1;3;230.0191539;metabolite;all
2087;r1p;5;2;7;230.0191539;metabolite;all
2088;ru5p-L;2;1;3;230.0191539;metabolite;all
2113;r5p;7;5;12;230.0191539;metabolite;all
2119;xu5p-D;3;2;5;230.0191539;metabolite;all
2208;ru5p-D;2;3;5;230.0191539;metabolite;all
2209;ara5p;1;1;2;230.0191539;metabolite;all
3443;r5p[e];0;1;1;230.0191539;metabolite;all
3444;r5p[p];1;0;1;230.0191539;metabolite;all
2245;sucgsa;1;1;2;231.0742871;metabolite;all
1927;3hddecACP;1;1;2;231.141876;metabolite;all
2158;gg4abut;1;1;2;232.1059216;metabolite;all
2219;sucorn;1;1;2;232.1059216;metabolite;all
3059;fe3hox[p];1;1;2;232.9371223;metabolite;all
3060;fe3hox;2;3;5;232.9371223;metabolite;all
3062;fe3hox[e];0;1;1;232.9371223;metabolite;all
2559;eig3p;1;1;2;238.0354727;metabolite;all
2302;2shchc;1;1;2;240.0633881;metabolite;all
2278;23dhbzs;3;1;4;241.0586371;metabolite;all
2095;tmrs2eACP;1;2;3;241.1626114;metabolite;all
2231;dkmpp;1;2;3;242.0013957;metabolite;all
2642;thymd;4;2;6;242.0902715;metabolite;all
3489;thymd[p];1;2;3;242.0902715;metabolite;all
3490;thymd[e];0;1;1;242.0902715;metabolite;all
2125;cytd;5;3;8;243.0855205;metabolite;all
2944;cytd[p];1;2;3;243.0855205;metabolite;all
2945;cytd[e];0;1;1;243.0855205;metabolite;all
2072;fc1p;1;1;2;244.034804;metabolite;all
2115;rml1p;1;1;2;244.034804;metabolite;all
2187;uri;6;3;9;244.0695361;metabolite;all
3543;uri[p];1;2;3;244.0695361;metabolite;all
3544;uri[e];0;1;1;244.0695361;metabolite;all
2347;btn;3;0;3;244.0881634;metabolite;all
2391;dmpp;2;1;3;246.005826;metabolite;all
2392;ipdp;1;5;6;246.005826;metabolite;all
2499;g3pg;22;2;24;246.0504541;metabolite;all
3106;g3pg[p];1;1;2;246.0504541;metabolite;all
3107;g3pg[e];0;1;1;246.0504541;metabolite;all
2342;pydx5p;4;3;7;247.0245737;metabolite;all
2253;sucglu;1;1;2;247.0692018;metabolite;all
2343;pyam5p;3;2;5;248.0562081;metabolite;all
2377;pdx5p;2;3;5;249.0402237;metabolite;all
3511;tungs[p];1;1;2;249.9462397;metabolite;all
3512;tungs;1;0;1;249.9462397;metabolite;all
3513;tungs[e];0;1;1;249.9462397;metabolite;all
2357;glucys;1;1;2;250.0623425;metabolite;all
2265;dad-5;2;1;3;251.1018393;metabolite;all
2644;dad-2;3;2;5;251.1018393;metabolite;all
2946;dad-2[p];1;1;2;251.1018393;metabolite;all
2947;dad-2[e];0;1;1;251.1018393;metabolite;all
2645;din;4;1;5;252.0858549;metabolite;all
2984;din[p];1;1;2;252.0858549;metabolite;all
2985;din[e];0;1;1;252.0858549;metabolite;all
2986;skm5p;1;1;2;254.0191539;metabolite;all
2388;dhnpt;1;1;2;255.0967539;metabolite;all
2066;ascb6p;1;1;2;255.9984185;metabolite;all
2468;hdca;14;5;19;256.2402303;metabolite;all
2672;hdca[p];1;1;2;256.2402303;metabolite;all
3215;hdca[e];0;1;1;256.2402303;metabolite;all
1930;3omrsACP;1;1;2;257.157526;metabolite;all
2214;pppi;5;1;6;257.9095563;metabolite;all
1976;2ddg6p;2;1;3;258.0140686;metabolite;all
1978;2dh3dgal6p;1;1;2;258.0140686;metabolite;all
2803;6pgl;1;1;2;258.0140686;metabolite;all
2537;g3pc;1;2;3;258.1101004;metabolite;all
3102;g3pc[p];1;1;2;258.1101004;metabolite;all
3103;g3pc[e];0;1;1;258.1101004;metabolite;all
2036;gam6p;5;1;6;259.045703;metabolite;all
2196;gam1p;0;2;2;259.045703;metabolite;all
3135;gam6p[p];1;1;2;259.045703;metabolite;all
3136;gam6p[e];0;1;1;259.045703;metabolite;all
1931;3hmrsACP;1;3;4;259.1731761;metabolite;all
2226;5mdr1p;1;1;2;260.0119604;metabolite;all
2227;5mdru1p;1;1;2;260.0119604;metabolite;all
2053;all6p;1;1;2;260.0297186;metabolite;all
2054;allul6p;1;1;2;260.0297186;metabolite;all
2058;f6p;12;4;16;260.0297186;metabolite;all
2064;g6p;8;4;12;260.0297186;metabolite;all
2069;f1p;1;1;2;260.0297186;metabolite;all
2077;gal1p;2;2;4;260.0297186;metabolite;all
2084;man6p;5;2;7;260.0297186;metabolite;all
2116;tag6p-D;1;1;2;260.0297186;metabolite;all
2149;g1p;7;5;12;260.0297186;metabolite;all
2194;man1p;1;2;3;260.0297186;metabolite;all
2484;mi1p-D;0;1;1;260.0297186;metabolite;all
3039;f6p[p];1;1;2;260.0297186;metabolite;all
3041;f6p[e];0;1;1;260.0297186;metabolite;all
3099;g1p[e];0;1;1;260.0297186;metabolite;all
3100;g1p[p];1;0;1;260.0297186;metabolite;all
3114;g6p[p];1;1;2;260.0297186;metabolite;all
3115;g6p[e];0;1;1;260.0297186;metabolite;all
3116;gal1p[e];0;1;1;260.0297186;metabolite;all
3117;gal1p[p];1;0;1;260.0297186;metabolite;all
3292;man6p[p];1;1;2;260.0297186;metabolite;all
3293;man6p[e];0;1;1;260.0297186;metabolite;all
2379;btnso;0;2;2;260.083078;metabolite;all
3445;tyrp;0;1;1;261.0402237;metabolite;all
3516;tyrp[e];0;1;1;261.0402237;metabolite;all
3517;tyrp[p];1;0;1;261.0402237;metabolite;all
2293;h2mb4p;1;2;3;262.0007406;metabolite;all
2156;galt1p;1;1;2;262.0453687;metabolite;all
2199;mnl1p;1;1;2;262.0453687;metabolite;all
2203;sbt6p;1;1;2;262.0453687;metabolite;all
2554;13dpg;2;0;2;265.9592697;metabolite;all
2569;rhcys;1;1;2;267.0776583;metabolite;all
2044;adn;5;4;9;267.0967539;metabolite;all
2652;dgsn;4;1;5;267.0967539;metabolite;all
2799;adn[p];1;2;3;267.0967539;metabolite;all
2800;adn[e];0;1;1;267.0967539;metabolite;all
2965;dgsn[p];1;1;2;267.0967539;metabolite;all
2966;dgsn[e];0;1;1;267.0967539;metabolite;all
3294;manglyc[p];1;1;2;268.0794321;metabolite;all
3295;manglyc[e];0;1;1;268.0794321;metabolite;all
2616;ins;5;3;8;268.0807695;metabolite;all
3243;ins[p];1;2;3;268.0807695;metabolite;all
3244;ins[e];0;1;1;268.0807695;metabolite;all
2240;acg5p;2;0;2;269.030053;metabolite;all
2099;tpalm2eACP;1;2;3;269.1939115;metabolite;all
2015;3dhgulnp;2;1;3;274.0089832;metabolite;all
3154;glcur1p[e];0;1;1;274.0089832;metabolite;all
3155;glcur1p[p];1;0;1;274.0089832;metabolite;all
3272;glcur1p;1;1;2;274.0089832;metabolite;all
2218;sucarg;1;1;2;274.1277197;metabolite;all
2078;6pgc;2;2;4;276.0246332;metabolite;all
2269;4r5au;2;1;3;276.1069842;metabolite;all
2292;2mecdp;1;1;2;277.9956552;metabolite;all
2324;rdmbzi;1;1;2;278.1266571;metabolite;all
2496;ocdcea;13;3;16;282.2558803;metabolite;all
2675;ocdcea[p];1;1;2;282.2558803;metabolite;all
3376;ocdcea[e];0;1;1;282.2558803;metabolite;all
2640;gsn;5;2;7;283.0916685;metabolite;all
3192;gsn[p];1;1;2;283.0916685;metabolite;all
3193;gsn[e];0;1;1;283.0916685;metabolite;all
2665;xtsn;3;2;5;284.0756841;metabolite;all
3551;xtsn[p];1;1;2;284.0756841;metabolite;all
3552;xtsn[e];0;1;1;284.0756841;metabolite;all
2491;ocdca;13;3;16;284.2715304;metabolite;all
2674;ocdca[p];1;1;2;284.2715304;metabolite;all
3375;ocdca[e];0;1;1;284.2715304;metabolite;all
1934;3opalmACP;1;1;2;285.1888262;metabolite;all
2806;gar;1;2;3;286.0566021;metabolite;all
2968;3ig3p;1;2;3;287.0558738;metabolite;all
1935;3hpalmACP;1;1;2;287.2044762;metabolite;all
2969;2dda7p;1;1;2;288.0246332;metabolite;all
2883;sl2a6o;2;0;2;289.0797664;metabolite;all
2804;s7p;1;2;3;290.0402833;metabolite;all
3186;gmhep1p;1;1;2;290.0402833;metabolite;all
3187;gmhep7p;1;1;2;290.0402833;metabolite;all
2882;sl26da;0;2;2;290.1114009;metabolite;all
2248;argsuc;1;1;2;290.1226343;metabolite;all
2782;acmum[p];1;1;2;293.1110666;metabolite;all
2783;acmum[e];0;1;1;293.1110666;metabolite;all
2232;5mta;1;1;2;297.0895603;metabolite;all
2103;toctd2eACP;1;2;3;297.2252117;metabolite;all
2284;2mahmp;1;2;3;299.007223;metabolite;all
2317;4ppan;1;1;2;299.0770032;metabolite;all
2035;acgam6p;4;1;5;301.0562677;metabolite;all
2038;acmanap;2;1;3;301.0562677;metabolite;all
2197;acgam1p;2;2;4;301.0562677;metabolite;all
2766;acgal1p[e];0;1;1;301.0562677;metabolite;all
2767;acgal1p[p];1;0;1;301.0562677;metabolite;all
2770;acgam1p[e];0;1;1;301.0562677;metabolite;all
2771;acgam1p[p];1;0;1;301.0562677;metabolite;all
3198;acgal1p;1;1;2;301.0562677;metabolite;all
2708;23ccmp[e];0;1;1;305.0412864;metabolite;all
2709;23ccmp[p];1;0;1;305.0412864;metabolite;all
3178;23ccmp;0;1;1;305.0412864;metabolite;all
2712;23cump[e];0;1;1;306.0253019;metabolite;all
2713;23cump[p];1;0;1;306.0253019;metabolite;all
3182;23cump;0;1;1;306.0253019;metabolite;all
2627;dcmp;1;3;4;307.0569364;metabolite;all
2956;dcmp[e];0;1;1;307.0569364;metabolite;all
2957;dcmp[p];1;0;1;307.0569364;metabolite;all
2251;gthrd;6;9;15;307.0838063;metabolite;all
3196;gthrd[p];2;1;3;307.0838063;metabolite;all
3197;gthrd[e];0;1;1;307.0838063;metabolite;all
2636;dump;2;4;6;308.040952;metabolite;all
3005;dump[e];0;1;1;308.040952;metabolite;all
3006;dump[p];1;0;1;308.040952;metabolite;all
2074;frulys;2;1;3;308.1583511;metabolite;all
3089;frulys[p];1;1;2;308.1583511;metabolite;all
3090;frulys[e];0;1;1;308.1583511;metabolite;all
2041;acnam;1;1;2;309.1059812;metabolite;all
2784;acnam[p];1;1;2;309.1059812;metabolite;all
2785;acnam[e];0;1;1;309.1059812;metabolite;all
2085;r15bp;1;1;2;309.9854845;metabolite;all
2807;fgam;2;1;3;314.0515167;metabolite;all
2393;grdp;1;1;2;314.0684262;metabolite;all
2309;dhpt;1;1;2;314.1127383;metabolite;all
1939;3hoctaACP;1;1;2;315.2357764;metabolite;all
2429;trdox;9;1;10;316.0299969;metabolite;all
2505;kdo8p;1;1;2;318.0351979;metabolite;all
2428;trdrd;1;9;10;318.0456469;metabolite;all
2632;dtmp;3;3;6;322.0566021;metabolite;all
3003;dtmp[e];0;1;1;322.0566021;metabolite;all
3004;dtmp[p];1;0;1;322.0566021;metabolite;all
2301;cmp;28;4;32;323.051851;metabolite;all
2902;cmp[e];0;1;1;323.051851;metabolite;all
2903;cmp[p];1;0;1;323.051851;metabolite;all
2745;3cmp[e];0;1;1;323.051851;metabolite;all
2746;3cmp[p];1;0;1;323.051851;metabolite;all
3179;3cmp;1;1;2;323.051851;metabolite;all
2976;3psme;1;1;2;324.0246332;metabolite;all
2383;ump;12;3;15;324.0358666;metabolite;all
2750;3ump[e];0;1;1;324.0358666;metabolite;all
2751;3ump[p];1;0;1;324.0358666;metabolite;all
3183;3ump;1;1;2;324.0358666;metabolite;all
3536;ump[e];0;1;1;324.0358666;metabolite;all
3537;ump[p];1;0;1;324.0358666;metabolite;all
2268;dmlz;1;1;2;326.1226343;metabolite;all
2643;camp;1;1;2;329.0525197;metabolite;all
2706;23camp[e];0;1;1;329.0525197;metabolite;all
2707;23camp[p];1;0;1;329.0525197;metabolite;all
3172;23camp;0;1;1;329.0525197;metabolite;all
2624;damp;1;3;4;331.0681698;metabolite;all
2950;damp[e];0;1;1;331.0681698;metabolite;all
2951;damp[p];1;0;1;331.0681698;metabolite;all
2654;dimp;1;2;3;332.0521854;metabolite;all
2982;dimp[e];0;1;1;332.0521854;metabolite;all
2983;dimp[p];1;0;1;332.0521854;metabolite;all
2366;nmn;2;3;5;334.0566021;metabolite;all
2542;nmn[p];1;2;3;334.0566021;metabolite;all
3354;nmn[e];0;1;1;334.0566021;metabolite;all
2540;g3pi;1;2;3;334.0664981;metabolite;all
3108;g3pi[p];1;1;2;334.0664981;metabolite;all
3109;g3pi[e];0;1;1;334.0664981;metabolite;all
2335;dhpmp;1;1;2;335.0630844;metabolite;all
2415;Sfglutth;1;1;2;335.0787209;metabolite;all
2272;nicrnt;3;2;5;336.0478941;metabolite;all
2401;hmgth;1;1;2;337.0943709;metabolite;all
2562;aicar;2;1;3;338.0627501;metabolite;all
2814;5aizc;0;2;2;339.0467657;metabolite;all
2815;5caiz;2;0;2;339.0467657;metabolite;all
2070;fdp;2;2;4;339.9960491;metabolite;all
2117;tagdp-D;1;1;2;339.9960491;metabolite;all
2033;malt;2;5;7;342.1162115;metabolite;all
2176;lcts;1;3;4;342.1162115;metabolite;all
2186;tre;1;2;3;342.1162115;metabolite;all
3255;lcts[p];2;1;3;342.1162115;metabolite;all
3256;lcts[e];0;1;1;342.1162115;metabolite;all
3280;malt[p];1;2;3;342.1162115;metabolite;all
3287;malt[e];0;1;1;342.1162115;metabolite;all
3472;sucr[p];1;1;2;342.1162115;metabolite;all
3473;sucr[e];0;1;1;342.1162115;metabolite;all
3503;tre[p];1;1;2;342.1162115;metabolite;all
3504;tre[e];0;1;1;342.1162115;metabolite;all
2710;23cgmp[e];0;1;1;345.0474344;metabolite;all
2711;23cgmp[p];1;0;1;345.0474344;metabolite;all
3180;23cgmp;0;1;1;345.0474344;metabolite;all
2286;thmmp;3;1;4;345.0780891;metabolite;all
415;amp;99;6;105;347.0630844;metabolite;all
2630;dgmp;1;3;4;347.0630844;metabolite;all
2833;amp[e];0;1;1;347.0630844;metabolite;all
2834;amp[p];1;0;1;347.0630844;metabolite;all
2963;dgmp[e];0;1;1;347.0630844;metabolite;all
2964;dgmp[p];1;0;1;347.0630844;metabolite;all
2743;3amp[e];0;1;1;347.0630844;metabolite;all
2744;3amp[p];1;0;1;347.0630844;metabolite;all
3173;3amp;1;1;2;347.0630844;metabolite;all
2181;man6pglyc;1;1;2;348.0457626;metabolite;all
2641;imp;4;5;9;348.0471;metabolite;all
3238;imp[e];0;1;1;348.0471;metabolite;all
3239;imp[p];1;0;1;348.0471;metabolite;all
2967;2cpr5p;1;1;2;349.0562677;metabolite;all
2981;pran;1;1;2;349.0562677;metabolite;all
350;4Fe4S;1;1;2;351.4;metabolite;all
2063;arbt6p;0;1;1;352.0559334;metabolite;all
2280;25drapp;1;1;2;353.0736491;metabolite;all
2281;5apru;1;1;2;354.0576647;metabolite;all
2308;6hmhptpp;1;1;2;355.0082856;metabolite;all
2246;ametam;1;1;2;355.154686;metabolite;all
2322;5aprbu;1;1;2;356.0733148;metabolite;all
2323;5prdmbz;1;1;2;358.0929876;metabolite;all
2320;pan4p;1;1;2;358.0963587;metabolite;all
2333;gmp;6;4;10;363.057999;metabolite;all
2747;3gmp[e];0;1;1;363.057999;metabolite;all
2748;3gmp[p];1;0;1;363.057999;metabolite;all
3181;3gmp;1;1;2;363.057999;metabolite;all
3189;gmp[e];0;1;1;363.057999;metabolite;all
3190;gmp[p];1;0;1;363.057999;metabolite;all
2664;xmp;3;3;6;364.0420146;metabolite;all
3549;xmp[e];0;1;1;364.0420146;metabolite;all
3550;xmp[p];1;0;1;364.0420146;metabolite;all
2805;fprica;2;0;2;366.0576647;metabolite;all
2832;orot5p;0;2;2;368.0256959;metabolite;all
2039;acmum6p;2;1;3;373.0773971;metabolite;all
2270;ribflv;7;3;10;376.1382844;metabolite;all
2410;rbflvrd;2;6;8;378.1539344;metabolite;all
2580;lgt-S;1;1;2;379.1049356;metabolite;all
2405;frdp;1;3;4;382.1310265;metabolite;all
318;ahcys;19;1;20;384.1215887;metabolite;all
2034;acmalt;1;0;1;384.1267762;metabolite;all
2625;dcdp;3;1;4;387.0232669;metabolite;all
2633;dudp;3;1;4;388.0072825;metabolite;all
2086;prpp;3;10;13;389.951815;metabolite;all
2327;amob;1;0;1;398.1128808;metabolite;all
317;amet;1;23;24;398.1372388;metabolite;all
2631;dtdp;3;1;4;402.0229326;metabolite;all
2319;4ppcys;1;1;2;402.0861879;metabolite;all
2622;cdp;2;3;5;403.0181816;metabolite;all
2151;udp;13;3;16;404.0021971;metabolite;all
2617;dadp;3;1;4;411.0345003;metabolite;all
2655;didp;1;0;1;412.0185159;metabolite;all
2150;tre6p;2;2;4;422.082542;metabolite;all
2185;suc6p;1;1;2;422.082542;metabolite;all
3285;malt6p;1;0;1;422.082542;metabolite;all
2338;thmpp;2;2;4;425.0444196;metabolite;all
2420;aps;1;1;2;427.0198993;metabolite;all
315;adp;256;5;261;427.0294149;metabolite;all
2349;pap;3;1;4;427.0294149;metabolite;all
2628;dgdp;3;1;4;427.0294149;metabolite;all
2619;idp;2;0;2;428.0134305;metabolite;all
3054;fe3dcit[p];1;1;2;433.9436382;metabolite;all
3055;fe3dcit[e];0;1;1;433.9436382;metabolite;all
2274;seramp;1;1;2;434.0951128;metabolite;all
2252;gtspmd;1;1;2;434.2311392;metabolite;all
470;gdp;18;5;23;443.0243296;metabolite;all
3143;gdp[e];0;1;1;443.0243296;metabolite;all
3144;gdp[p];1;0;1;443.0243296;metabolite;all
2358;dhf;2;1;3;443.1553314;metabolite;all
2666;xdp;1;0;1;444.0083451;metabolite;all
2305;thf;8;2;10;445.1709815;metabolite;all
2808;25aics;1;1;2;454.0737087;metabolite;all
2363;fmn;12;3;15;456.1046149;metabolite;all
2432;methf;1;1;2;456.1626078;metabolite;all
2304;mlthf;2;4;6;457.1709815;metabolite;all
2404;fmnh2;2;11;13;458.1202649;metabolite;all
2430;5mthf;1;1;2;459.1866315;metabolite;all
2822;dcamp;1;1;2;463.074043;metabolite;all
2626;dctp;2;2;4;466.9895975;metabolite;all
2634;dutp;3;1;4;467.973613;metabolite;all
2431;10fthf;1;5;6;473.1658961;metabolite;all
3088;1agpe180;1;1;2;481.3168395;metabolite;all
2369;dttp;1;2;3;481.9892631;metabolite;all
2289;ctp;2;13;15;482.9845121;metabolite;all
2273;23dhba;1;1;2;483.0791284;metabolite;all
2368;utp;1;5;6;483.9685277;metabolite;all
2623;datp;2;2;4;491.0008308;metabolite;all
2648;ditp;1;2;3;491.9848464;metabolite;all
2334;ahdt;1;2;3;494.9957455;metabolite;all
2180;malttr;2;2;4;504.1690349;metabolite;all
3288;malttr[p];1;1;2;504.1690349;metabolite;all
3289;malttr[e];0;1;1;504.1690349;metabolite;all
2421;paps;1;2;3;506.9862298;metabolite;all
313;atp;4;355;359;506.9957455;metabolite;all
2629;dgtp;2;2;4;506.9957455;metabolite;all
2618;itp;1;3;4;507.979761;metabolite;all
2290;4c2me;1;1;2;521.0811757;metabolite;all
413;gtp;2;49;51;522.9906601;metabolite;all
3200;gtp[e];0;1;1;522.9906601;metabolite;all
3201;gtp[p];1;0;1;522.9906601;metabolite;all
2660;xtp;1;2;3;523.9746757;metabolite;all
3528;udpLa4o;1;1;2;534.0288058;metabolite;all
3533;udpLa4n;1;1;2;535.0604403;metabolite;all
2373;ckdo;1;3;4;543.1101538;metabolite;all
1950;dtdp4d6dm;1;1;2;546.0651913;metabolite;all
2258;dtdp4d6dg;1;2;3;546.0651913;metabolite;all
2259;dtdp4addg;1;1;2;547.0968258;metabolite;all
1951;dtdprmn;1;1;2;548.0808414;metabolite;all
2412;adprib;1;1;2;559.0716737;metabolite;all
2566;prbamp;1;1;2;559.0716737;metabolite;all
2261;ppp9;2;1;3;562.2580056;metabolite;all
3534;udpLa4fn;1;1;2;563.0553549;metabolite;all
2370;dtdpglu;1;1;2;564.075756;metabolite;all
2839;arbtn-fe3[p];1;1;2;564.2278872;metabolite;all
2840;arbtn-fe3;2;3;5;564.2278872;metabolite;all
2844;arbtn-fe3[e];0;1;1;564.2278872;metabolite;all
1970;udpg;1;11;12;566.0550206;metabolite;all
2152;udpgal;2;2;4;566.0550206;metabolite;all
2661;udpgalfur;1;1;2;566.0550206;metabolite;all
3526;udpgal[e];0;1;1;566.0550206;metabolite;all
3527;udpgal[p];1;0;1;566.0550206;metabolite;all
3531;udpg[e];0;1;1;566.0550206;metabolite;all
3532;udpg[p];1;0;1;566.0550206;metabolite;all
2260;pppg9;2;2;4;568.3049558;metabolite;all
2567;prfp;1;1;2;577.0822384;metabolite;all
2561;prlp;1;1;2;577.0822384;metabolite;all
1971;udpglcur;1;2;3;580.0342851;metabolite;all
3529;udpglcur[e];0;1;1;580.0342851;metabolite;all
3530;udpglcur[p];1;0;1;580.0342851;metabolite;all
183;glytrna;1;1;2;580.0832467;RNA;all
2635;gdpddman;1;1;2;587.0665883;metabolite;all
2555;adpglc;1;1;2;589.0822384;metabolite;all
3191;gdpfuc;1;0;1;589.0822384;metabolite;all
2757;dtdp4aaddg;1;1;2;589.1073905;metabolite;all
2300;2p4c2me;1;1;2;601.0475063;metabolite;all
2364;ppgpp;2;1;3;602.9569906;metabolite;all
2367;gdpmann;1;3;4;605.077153;metabolite;all
3450;udpacgal;0;1;1;607.0815697;metabolite;all
3524;udpacgal[e];0;1;1;607.0815697;metabolite;all
3525;udpacgal[p];1;0;1;607.0815697;metabolite;all
2191;uacgam;1;6;7;607.0815697;metabolite;all
2647;uacmam;1;1;2;607.0815697;metabolite;all
3521;uacgam[e];0;1;1;607.0815697;metabolite;all
3522;uacgam[p];1;0;1;607.0815697;metabolite;all
253;sertrna;1;1;2;610.0938114;RNA;all
2943;sertrna(sec);1;1;2;610.0938114;RNA;all
2409;gthox;4;1;5;612.1519625;metabolite;all
3194;gthox[e];0;1;1;612.1519625;metabolite;all
3195;gthox[p];1;0;1;612.1519625;metabolite;all
3076;feoxam[p];1;1;2;613.2648249;metabolite;all
3077;feoxam;2;3;5;613.2648249;metabolite;all
3079;feoxam[e];0;1;1;613.2648249;metabolite;all
2402;pheme;1;2;3;616.177293;metabolite;all
3414;pheme[p];1;1;2;616.177293;metabolite;all
3415;pheme[e];1;0;1;616.177293;metabolite;all
2649;adphep-DD;1;1;2;619.092803;metabolite;all
2650;adphep-LD;1;4;5;619.092803;metabolite;all
232;protrna;1;1;2;620.1145468;RNA;all
2779;uacmamu;1;1;2;621.0608342;metabolite;all
260;thrtrna;1;1;2;624.1094614;RNA;all
225;asntrna;1;1;2;637.1047104;RNA;all
162;asptrna;1;1;2;638.088726;RNA;all
2299;2oph;1;2;3;638.5426669;metabolite;all
204;lystrna;1;1;2;651.156746;RNA;all
2294;2ohph;2;1;3;654.5375815;metabolite;all
3047;minohp;0;1;1;659.8613712;metabolite;all
3323;minohp[e];0;1;1;659.8613712;metabolite;all
3324;minohp[p];1;0;1;659.8613712;metabolite;all
190;histrna;1;1;2;660.1206948;RNA;all
2264;cpppg3;1;2;3;660.3159144;metabolite;all
1969;nad;50;65;115;664.1163983;metabolite;all
2359;dnad;1;1;2;665.1004138;metabolite;all
1967;nadh;62;47;109;665.1247719;metabolite;all
2179;maltttr;4;2;6;666.2218584;metabolite;all
3290;maltttr[p];1;1;2;666.2218584;metabolite;all
3291;maltttr[e];0;1;1;666.2218584;metabolite;all
2556;glycogen;2;2;4;666.2218584;metabolite;all
2295;2omph;1;2;3;668.5532315;metabolite;all
2275;enter;4;3;7;669.1442172;metabolite;all
3073;enter[p];1;1;2;669.1442172;metabolite;all
3074;enter[e];1;0;1;669.1442172;metabolite;all
176;phetrna;1;1;2;670.1301969;RNA;all
2954;sectrna;1;0;1;674.0154181;RNA;all
1957;uaccg;1;1;2;677.087049;metabolite;all
1958;uamr;1;3;4;679.102699;metabolite;all
2306;3ophb;1;1;2;682.5324961;metabolite;all
2365;gdptp;1;1;2;682.9233211;metabolite;all
2360;dpcoa;1;2;3;687.1488784;metabolite;all
2228;lipidX;1;1;2;711.4322632;metabolite;all
2558;prbatp;1;1;2;719.0043347;metabolite;all
3027;feenter;2;4;6;719.0338502;metabolite;all
3072;feenter[p];1;1;2;719.0338502;metabolite;all
3075;feenter[e];0;1;1;719.0338502;metabolite;all
2313;octdp;1;2;3;722.4440278;metabolite;all
2168;q8;6;16;22;726.5587108;metabolite;all
3066;fecrm[p];1;1;2;740.2302303;metabolite;all
3067;fecrm;2;3;5;740.2302303;metabolite;all
3069;fecrm[e];0;1;1;740.2302303;metabolite;all
1925;nadp;62;21;83;744.0827288;metabolite;all
1923;nadph;20;61;81;745.0911024;metabolite;all
2682;uama;1;1;2;750.1398128;metabolite;all
267;valtrna;1;1;2;756.176867;RNA;all
155;cystrna;1;1;2;760.1176379;RNA;all
308;coa;39;32;71;767.115209;metabolite;all
197;iletrna;1;1;2;770.1925171;RNA;all
218;leutrna;1;1;2;770.1925171;RNA;all
1953;fad;8;12;20;785.1571346;metabolite;all
239;glntrna;1;1;2;785.1670306;RNA;all
169;glutrna;1;2;3;786.1510462;RNA;all
1955;fadh2;12;7;19;787.1727847;metabolite;all
2897;mettrna;1;1;2;788.148938;RNA;all
3520;u3hga;1;1;2;791.2642851;metabolite;all
306;accoa;12;24;36;809.1257736;metabolite;all
246;argtrna;1;1;2;813.2095641;RNA;all
2898;fmettrna;1;0;1;816.1438526;RNA;all
281;tyrtrna;1;1;2;820.1717816;metabolite;all
2013;ppcoa;3;3;6;823.1414237;metabolite;all
2193;u3aga;1;1;2;833.2748497;metabolite;all
2130;b2coa;2;0;2;835.1414237;metabolite;all
2620;ap4a;0;1;1;836.0482652;metabolite;all
2266;uppg3;1;2;3;836.2752313;metabolite;all
2028;btcoa;2;1;3;837.1570738;metabolite;all
2407;hemeO;1;0;1;838.3756585;metabolite;all
274;trptrna;1;1;2;843.187766;RNA;all
2380;udcpp;4;3;7;846.665498;metabolite;all
3523;udcpp[p];0;1;1;846.665498;metabolite;all
1980;aacoa;3;1;4;851.1363383;metabolite;all
2201;malcoa;1;1;2;853.1156029;metabolite;all
1979;3hbcoa;0;2;2;853.1519884;metabolite;all
2411;hmbil;1;1;2;854.285796;metabolite;all
2394;scl;1;1;2;862.2908814;metabolite;all
2131;hx2coa;2;0;2;863.1727238;metabolite;all
2267;dscl;1;1;2;864.3065315;metabolite;all
2172;mmcoa-S;1;1;2;867.131253;metabolite;all
2198;mmcoa-R;1;1;2;867.131253;metabolite;all
2205;succoa;3;4;7;867.131253;metabolite;all
2659;gp4g;0;1;1;868.0380944;metabolite;all
1982;3ohcoa;1;1;2;879.1676385;metabolite;all
2680;uamag;1;1;2;879.1824059;metabolite;all
1981;3hhcoa;0;2;2;881.1832885;metabolite;all
2068;phaccoa;1;0;1;885.1570738;metabolite;all
2133;oc2coa;2;0;2;891.204024;metabolite;all
2692;ctbtcoa;2;1;3;893.2065494;metabolite;all
2132;occoa;2;2;4;893.219674;metabolite;all
2739;bbtcoa;0;1;1;895.2221995;metabolite;all
1984;3oocoa;1;1;2;907.1989386;metabolite;all
2344;pmcoa;0;1;1;909.1782031;metabolite;all
1983;3hocoa;0;2;2;909.2145886;metabolite;all
2688;crncoa;3;2;5;911.2171141;metabolite;all
2621;ap5a;0;1;1;916.0145957;metabolite;all
2403;sheme;1;0;1;916.2101688;metabolite;all
2135;dc2coa;2;0;2;919.2353241;metabolite;all
1986;3odcoa;1;1;2;935.2302387;metabolite;all
1994;3oodcoa;1;1;2;935.2302387;metabolite;all
1985;3hdcoa;0;2;2;937.2458888;metabolite;all
2137;dd2coa;2;0;2;947.2666242;metabolite;all
2136;ddcacoa;2;2;4;949.2822743;metabolite;all
1988;3oddcoa;1;1;2;963.2615388;metabolite;all
1987;3hddcoa;0;2;2;965.2771889;metabolite;all
2353;sbzcoa;1;1;2;971.1574677;metabolite;all
2139;td2coa;3;0;3;975.2979243;metabolite;all
2138;tdcoa;2;2;4;977.3135744;metabolite;all
0;mRNAcodonUAG;0;1;1;990;RNA;all
69;mRNAcodonUAA;0;2;2;990;RNA;all
73;mRNAcodonUGA;0;1;1;990;RNA;all
109;mRNAcodonala;1;1;2;990;RNA;all
157;mRNAcodoncys;1;1;2;990;RNA;all
164;mRNAcodonasp;1;1;2;990;RNA;all
171;mRNAcodonglu;1;1;2;990;RNA;all
178;mRNAcodonphe;1;1;2;990;RNA;all
185;mRNAcodongly;1;1;2;990;RNA;all
192;mRNAcodonhis;1;1;2;990;RNA;all
199;mRNAcodonile;1;1;2;990;RNA;all
206;mRNAcodonlys;1;1;2;990;RNA;all
213;mRNAcodonmet;1;1;2;990;RNA;all
220;mRNAcodonleu;1;1;2;990;RNA;all
227;mRNAcodonasn;1;1;2;990;RNA;all
234;mRNAcodonpro;1;1;2;990;RNA;all
241;mRNAcodongln;1;1;2;990;RNA;all
248;mRNAcodonarg;1;1;2;990;RNA;all
255;mRNAcodonser;1;1;2;990;RNA;all
262;mRNAcodonthr;1;1;2;990;RNA;all
269;mRNAcodonval;1;1;2;990;RNA;all
276;mRNAcodontrp;1;1;2;990;RNA;all
283;mRNAcodontyr;1;1;2;990;RNA;all
295;ShineDalgarnomRNA - cap5 - mRNAcodonMet;0;1;1;990;assembly;all
302;cap5 - mRNAcodonMet;0;1;1;990;assembly;all
1964;malthx;6;3;9;990.3275052;metabolite;all
3282;malthx[p];1;1;2;990.3275052;metabolite;all
3283;malthx[e];0;1;1;990.3275052;metabolite;all
1990;3otdcoa;1;1;2;991.292839;metabolite;all
1989;3htdcoa;0;2;2;993.308489;metabolite;all
2141;hdd2coa;3;0;3;1003.329224;metabolite;all
2140;pmtcoa;2;2;4;1005.344875;metabolite;all
2229;u23ga;1;2;3;1017.457565;metabolite;all
1992;3ohdcoa;1;1;2;1019.324139;metabolite;all
1991;3hhdcoa;0;2;2;1021.339789;metabolite;all
2143;od2coa;3;0;3;1031.360525;metabolite;all
2142;stcoa;1;2;3;1033.376175;metabolite;all
2361;2tpr3dpcoa;1;0;1;1059.090129;metabolite;all
2772;unaga;1;1;2;1129.711201;metabolite;all
2381;ugmda;1;1;2;1193.341426;metabolite;all
2329;adocbi;1;1;2;1239.583194;metabolite;all
2330;adocbip;1;1;2;1319.549524;metabolite;all
2230;lipidAds;1;1;2;1324.887631;metabolite;all
2352;cbl1;1;1;2;1329.572151;metabolite;all
2877;cbl1[p];1;1;2;1329.572151;metabolite;all
2878;cbl1[e];0;1;1;1329.572151;metabolite;all
2758;unagamu;1;1;2;1346.769838;metabolite;all
2291;lipidA;1;1;2;1404.853962;metabolite;all
2332;adocbl;3;0;3;1578.65834;metabolite;all
2801;adocbl[p];1;1;2;1578.65834;metabolite;all
2802;adocbl[e];0;1;1;1578.65834;metabolite;all
3338;kdolipid4;1;1;2;1624.912264;metabolite;all
2331;agdpcbi;1;1;2;1664.596959;metabolite;all
2382;uagmda;1;1;2;1715.971057;metabolite;all
3020;kdo2lipid4;1;3;4;1844.970567;metabolite;all
3248;kdo2lipid4[p];1;1;2;1844.970567;metabolite;all
3249;kdo2lipid4[e];1;0;1;1844.970567;metabolite;all
2582;uaagmda;1;2;3;1919.05043;metabolite;all
3021;kdo2lipid4L;1;1;2;2027.137632;metabolite;all
3022;lipa;1;5;6;2237.335998;metabolite;all
3259;lipa[p];1;1;2;2237.335998;metabolite;all
3262;lipa[e];1;0;1;2237.335998;metabolite;all
3025;enlipa[p];0;1;1;2360.344528;metabolite;all
3026;enlipa[e];1;0;1;2360.344528;metabolite;all
3399;enlipa;2;0;2;2360.344528;metabolite;all
369;rpmH;0;1;1;5380.3;assembly;all
330;prerpmG;0;1;1;6371.5;assembly;all
331;rpmG;1;1;2;6371.5;assembly;all
368;rpmF;0;1;1;6446.3;assembly;all
455;rmf;1;1;2;6507.4;assembly;all
367;rpmD;0;1;1;6541.7;assembly;all
366;rpmC;0;1;1;7273.4;assembly;all
382;rpmI;0;1;1;7288.8;assembly;all
821;b4407;0;1;1;7311.2128;protein;all
291;if1;1;4;5;8249.5;protein;all
1291;b3737;0;1;1;8256.0356;protein;all
1690;b1677;0;1;1;8323.3941;protein;all
407;rpsU;0;1;1;8499.9;assembly;all
631;b1094;0;4;4;8639.4165;protein;all
319;prerpsR;0;1;1;8986.3;assembly;all
320;rpsR;1;1;2;8986.3;assembly;all
379;rpmB;0;1;1;9006.4;assembly;all
582;b2415;0;13;13;9119.2594;protein;all
378;rpmA;0;1;1;9124.4;assembly;all
920;b3610;0;3;3;9137.3986;protein;all
388;rpsP;0;1;1;9190.4;assembly;all
390;rpsT;0;1;1;9684.3;assembly;all
913;b0849;0;3;3;9684.7372;protein;all
387;rpsQ;0;1;1;9704.3;assembly;all
1659;b2093;0;1;1;10221.9412;protein;all
386;rpsO;0;1;1;10268.6;assembly;all
398;rpsS;0;1;1;10430.2;assembly;all
742;b0617;0;1;1;10689.1593;protein;all
377;rplY;0;1;1;10693.3;assembly;all
458;hpf;1;1;2;10750.1;assembly;all
1198;b2279;0;1;1;10844.8939;protein;all
1427;b4194;0;1;1;10895.5026;protein;all
1878;b3670;0;1;1;11105.6394;protein;all
364;rplW;0;1;1;11199;assembly;all
365;rplX;0;1;1;11316.1;assembly;all
574;b2540;0;1;1;11328.6531;protein;all
869;b1308;0;1;1;11475.1766;protein;all
1211;b3029;0;2;2;11532.276;protein;all
362;rplU;0;1;1;11564.2;assembly;all
400;rpsJ;0;1;1;11735.4;assembly;all
924;b3781;0;7;7;11806.4819;protein;all
1188;b0429;0;1;1;12029.3367;protein;all
1581;b3425;0;1;1;12082.3382;protein;all
363;rplV;0;1;1;12226.1;assembly;all
1347;b0573;0;1;1;12251.0239;protein;all
1213;b3366;0;1;1;12283.8616;protein;all
324;prerplL;0;1;1;12295.1;assembly;all
325;rplL;1;1;2;12295.1;assembly;all
376;rplR;0;1;1;12769.5;assembly;all
460;pY;1;1;2;12784.4;protein;all
1263;b0722;0;1;1;12867.3719;protein;all
918;b1654;0;3;3;12878.6167;protein;all
397;rpsM;0;1;1;13099.2;assembly;all
725;b4151;0;1;1;13106.7709;protein;all
360;rplS;0;1;1;13133.1;assembly;all
943;b4042;0;7;7;13244.525;protein;all
1858;b2704;0;1;1;13303.8888;protein;all
361;rplT;0;1;1;13496.8;assembly;all
357;rplN;0;1;1;13540.9;assembly;all
861;b3058;0;1;1;13619.3617;protein;all
1301;b3739;0;1;1;13631.5484;protein;all
395;rpsL;0;1;1;13736.9;assembly;all
929;b2904;0;1;1;13811.0271;protein;all
811;b0131;0;1;1;13833.5769;protein;all
316;prerpsK;1;1;2;13844.8;assembly;all
396;rpsK;0;1;1;13844.8;assembly;all
808;b2563;0;1;1;14052.1201;protein;all
800;b2303;0;1;1;14081.8582;protein;all
516;b2579;0;1;1;14284.0081;protein;all
1262;b0721;0;1;1;14298.9785;protein;all
359;rplQ;0;1;1;14364.4;assembly;all
399;rpsI;0;1;1;14856;assembly;all
326;prerplK;0;1;1;14875.2;assembly;all
328;rplK;2;1;3;14875.2;assembly;all
1027;b1651;0;1;1;14919.6687;protein;all
799;b0099;0;3;3;14926.8881;protein;all
358;rplO;0;1;1;14980.2;assembly;all
726;b4152;0;1;1;15014.8535;protein;all
1123;b1759;0;2;2;15045.9347;protein;all
1294;b3731;0;1;1;15068.0943;protein;all
401;rbfA;1;1;2;15154.3;assembly;all
309;prerpsF;0;1;1;15186.9;assembly;all
314;rpsF;1;1;2;15186.9;assembly;all
329;prerplP;0;1;1;15281;assembly;all
384;rplP;0;1;1;15281;assembly;all
1845;b3748;0;1;1;15292.3325;protein;all
1019;b1778;0;2;2;15451.0166;protein;all
1093;b2518;0;8;8;15463.2556;protein;all
1327;b3005;0;1;1;15526.8184;protein;all
922;b2582;0;7;7;15554.6049;protein;all
1450;b2490;0;1;1;15576.8106;protein;all
375;rplI;0;1;1;15768.9;assembly;all
1459;b3503;0;1;1;15853.1243;protein;all
356;rplM;0;1;1;16018.3;assembly;all
543;b4090;0;2;2;16073.1342;protein;all
758;b0415;0;1;1;16156.3027;protein;all
1140;b3640;0;1;1;16286.4788;protein;all
1065;b2203;0;1;1;16296.3614;protein;all
1132;b2251;0;3;3;16370.5312;protein;all
1207;b2288;0;1;1;16457.1321;protein;all
1231;b3255;0;1;1;16687.0389;protein;all
778;b2746;0;1;1;16897.3394;protein;all
1660;b2094;0;1;1;16907.2513;protein;all
1026;b0963;0;1;1;16918.3812;protein;all
1148;b2868;0;1;1;16921.5718;protein;all
1144;b0238;0;3;3;16970.3864;protein;all
1103;b0180;0;12;12;17032.757;protein;all
1060;b0340;0;1;1;17048.6279;protein;all
1373;b4244;0;1;1;17120.434;protein;all
1428;b4195;0;1;1;17237.3317;protein;all
1290;b3736;0;1;1;17263.7477;protein;all
798;b1865;0;2;2;17305.5531;protein;all
770;b1134;0;2;2;17432.7138;protein;all
1106;b4237;0;2;2;17445.7237;protein;all
1908;b3577;0;1;1;17515.656;protein;all
304;prerpsE;0;1;1;17603.2;assembly;all
307;rpsE;1;1;2;17603.2;assembly;all
1587;b2480;0;2;2;17633.7313;protein;all
1602;b1646;0;1;1;17680.7756;protein;all
373;rplJ;0;1;1;17711.4;assembly;all
1352;b0523;0;1;1;17780.1078;protein;all
835;b3634;0;1;1;17836.4355;protein;all
1882;b0078;0;1;1;17976.5416;protein;all
858;b0048;0;1;1;17999.167;protein;all
794;b0142;0;1;1;18078.5667;protein;all
1058;b0505;0;1;1;18169.3325;protein;all
1135;b4394;0;3;3;18212.4307;protein;all
1271;b2417;0;4;4;18250.8353;protein;all
1664;b2051;0;1;1;18273.248;protein;all
1204;b2285;0;1;1;18589.8475;protein;all
854;b4039;0;1;1;18776.687;protein;all
372;rplF;0;2;2;18903.5;assembly;all
1102;b0954;0;13;13;18968.8386;protein;all
1558;b0388;0;1;1;19150.606;protein;all
1298;b3735;0;1;1;19332.013;protein;all
1025;b2687;0;1;1;19415.9916;protein;all
958;b0418;0;14;14;19417.8997;protein;all
1557;b3390;0;1;1;19537.811;protein;all
561;b3437;0;1;1;19543.0434;protein;all
1104;b2895;0;3;3;19699.9514;protein;all
676;b4226;0;1;1;19703.3153;protein;all
1110;b0684;0;3;3;19736.6991;protein;all
1074;b0469;0;1;1;19858.6157;protein;all
1199;b2280;0;1;1;19874.4052;protein;all
949;b3198;0;1;1;19996.8805;protein;all
393;rpsG;0;1;1;20018.9;assembly;all
534;b0459;0;2;2;20095.7592;protein;all
1145;b0125;0;2;2;20115.0133;protein;all
1590;b1185;0;1;1;20141.9674;protein;all
1448;b2488;0;1;1;20159.1873;protein;all
796;b1993;0;2;2;20163.7742;protein;all
1721;b0696;0;1;1;20266.8934;protein;all
744;b0614;0;1;1;20270.1254;protein;all
1169;b2720;0;1;1;20309.1664;protein;all
896;b2889;0;1;1;20508.0268;protein;all
1037;b0110;0;4;4;20535.9308;protein;all
1200;b2281;0;1;1;20537.5482;protein;all
288;if3;1;4;5;20563.7;protein;all
573;b2539;0;1;1;20578.989;protein;all
1856;b2702;0;1;1;20580.0914;protein;all
402;rimM;1;1;2;20605.2;assembly;all
81;rrf;60;60;120;20638.3;protein;all
474;RimI;1;1;2;20680.3;protein;all
782;b2311;0;1;1;20694.7666;protein;all
950;b1912;0;7;7;20700.3721;protein;all
1054;b4071;0;1;1;20714.2866;protein;all
564;b4094;0;1;1;20729.3504;protein;all
851;b3360;0;1;1;20771.6199;protein;all
592;b2690;0;1;1;20779.5794;protein;all
1855;b0222;0;1;1;20814.5109;protein;all
560;b4268;0;1;1;21003.7502;protein;all
1136;b2954;0;3;3;21038.5825;protein;all
1090;b3397;0;1;1;21152.9129;protein;all
1035;b1488;0;1;1;21212.8056;protein;all
753;b3850;0;2;2;21226.0465;protein;all
1303;b2578;0;2;2;21248.0356;protein;all
1131;b2065;0;1;1;21249.0072;protein;all
875;b0937;0;2;2;21253.0452;protein;all
1570;b1656;0;1;1;21265.4935;protein;all
1128;b2038;0;1;1;21269.8381;protein;all
1683;b0200;0;1;1;21294.0077;protein;all
502;b4477;0;1;1;21390.3435;protein;all
1003;b2023;0;1;1;21652.617;protein;all
1800;b2033;0;1;1;21674.8297;protein;all
334;rsmD;1;1;2;21677.3;assembly;all
1665;b2467;0;1;1;21748.4027;protein;all
809;b3475;0;1;1;21767.5417;protein;all
1742;b0622;0;2;2;21769.2935;protein;all
885;b1277;0;1;1;21835.7247;protein;all
1173;b2724;0;1;1;21873.0606;protein;all
695;b1584;0;2;2;21886.7495;protein;all
1222;b3028;0;3;3;21890.6384;protein;all
812;b1270;0;2;2;21998.6285;protein;all
355;rplD;0;1;1;22086.3;assembly;all
1441;b2481;0;1;1;22154.1544;protein;all
1853;b1193;0;4;4;22226.2858;protein;all
321;prerplC;0;1;1;22243.2;assembly;all
323;rplC;1;1;2;22243.2;assembly;all
1325;b1850;0;2;2;22283.7565;protein;all
905;b2750;0;1;1;22321.0375;protein;all
1017;b0841;0;2;2;22398.3829;protein;all
1712;b3824;0;1;1;22426.493;protein;all
1884;b3823;0;1;1;22473.8321;protein;all
1871;b0071;0;1;1;22487.2053;protein;all
1151;b2498;0;1;1;22532.9976;protein;all
827;b0103;0;1;1;22621.4247;protein;all
1189;b0430;0;1;1;22622.3708;protein;all
580;b1199;0;1;1;22631.5076;protein;all
666;b3062;0;1;1;22679.2148;protein;all
305;rimJ;1;1;2;22687.6;protein;all
1127;b2291;0;6;6;22707.797;protein;all
1249;b1589;0;1;1;22751.5482;protein;all
1008;b2026;0;2;2;22755.554;protein;all
1340;b2914;0;1;1;22860.1279;protein;all
1224;b0895;0;1;1;22868.7377;protein;all
530;b2222;0;1;1;22959.4212;protein;all
946;b0404;0;7;7;22960.8319;protein;all
988;b0825;0;1;1;22996.5558;protein;all
768;b3993;0;1;1;23014.9878;protein;all
1807;b2201;0;1;1;23052.9668;protein;all
1569;b3908;0;1;1;23096.7999;protein;all
1068;b2202;0;2;2;23100.3141;protein;all
1591;b3860;0;1;1;23104.2622;protein;all
1424;b2923;0;2;2;23175.4283;protein;all
1341;b4301;0;1;1;23214.193;protein;all
589;b2738;0;1;1;23222.2055;protein;all
1344;b2500;0;1;1;23237.9959;protein;all
1763;b0198;0;1;1;23255.7965;protein;all
760;b0583;0;1;1;23258.2839;protein;all
793;b0638;0;1;1;23308.2011;protein;all
1022;b4219;0;2;2;23314.7748;protein;all
897;b3041;0;1;1;23353.2335;protein;all
1445;b2485;0;1;1;23361.2372;protein;all
892;b1768;0;1;1;23361.7852;protein;all
333;rsmG;1;1;2;23430.8;assembly;all
523;b3581;0;1;1;23444.486;protein;all
792;b1662;0;1;1;23444.6333;protein;all
1101;b1238;0;2;2;23456.312;protein;all
385;rpsD;0;1;1;23468.8;assembly;all
529;b2221;0;1;1;23525.938;protein;all
989;b3946;0;1;1;23554.9463;protein;all
1396;b3642;0;1;1;23566.7061;protein;all
522;b4196;0;1;1;23577.8052;protein;all
1075;b0474;0;13;13;23585.7353;protein;all
1095;b3648;0;2;2;23592.4243;protein;all
1806;b2200;0;1;1;23618.5137;protein;all
1633;b0494;0;21;21;23621.8715;protein;all
1695;b0875;0;1;1;23702.4879;protein;all
1579;b0339;0;1;1;23763.997;protein;all
588;b2800;0;1;1;23775.0463;protein;all
1096;b1098;0;1;1;23782.8486;protein;all
87;trnacys;5;2;7;23842.1;RNA;all
91;trnagly;5;2;7;23998.1;RNA;all
971;b4395;0;1;1;24064.9577;protein;all
537;b3223;0;1;1;24073.392;protein;all
99;trnagln;5;2;7;24124;RNA;all
813;b0778;0;1;1;24139.2951;protein;all
389;rpsF * rpsR;1;1;2;24173.2;assembly;all
1868;b3790;0;1;1;24220.0712;protein;all
916;b1064;0;4;4;24349.9203;protein;all
1124;b2066;0;2;2;24352.8436;protein;all
693;b0159;0;3;3;24353.6853;protein;all
1674;b0810;0;1;1;24363.9935;protein;all
94;trnalys;5;2;7;24441.4;RNA;all
89;trnaglu;6;2;8;24441.5;RNA;all
102;trnathr;5;2;7;24486.5;RNA;all
97;trnaasn;5;2;7;24496.4;RNA;all
104;trnatrp;5;2;7;24525.5;RNA;all
833;b0639;0;2;2;24527.6398;protein;all
103;trnaval;5;2;7;24546.5;RNA;all
90;trnaphe;5;2;7;24548;RNA;all
1342;b3386;0;1;1;24553.9646;protein;all
1055;b4072;0;1;1;24567.2191;protein;all
83;trnaala;5;2;7;24587.5;RNA;all
107;alatrna;1;1;2;24587.5;RNA;all
1310;b3892;0;1;1;24606.0591;protein;all
1413;b2308;0;2;2;24648.9665;protein;all
354;rplA;0;1;1;24729.3;assembly;all
1094;b0910;0;3;3;24746.0363;protein;all
211;emettrna;0;1;1;24791.6;RNA;all
886;b2153;0;1;1;24830.3397;protein;all
100;trnaarg;5;2;7;24852.7;RNA;all
343;rluA;1;1;2;24860.4;assembly;all
95;trnamet;5;2;7;24865.7;RNA;all
293;imettrna;0;3;3;24865.7;RNA;all
88;trnaasp;5;2;7;24878.6;RNA;all
98;trnapro;5;2;7;24909.7;RNA;all
1417;b0861;0;1;1;24913.4678;protein;all
1433;b0653;0;1;1;24914.4204;protein;all
93;trnaile;5;2;7;24918.7;RNA;all
1071;b2205;0;1;1;24924.4628;protein;all
1774;b0764;0;1;1;24938.5108;protein;all
1874;b0066;0;1;1;24998.8635;protein;all
1206;b2287;0;1;1;25055.5645;protein;all
1580;b0126;0;1;1;25096.4793;protein;all
656;b4198;0;1;1;25277.4424;protein;all
1137;b4374;0;3;3;25300.3069;protein;all
1308;b1476;0;1;1;25368.1979;protein;all
1183;b1227;0;1;1;25497.0712;protein;all
1480;b2128;0;1;1;25514.1974;protein;all
655;b0061;0;1;1;25518.6105;protein;all
893;b1638;0;2;2;25544.8351;protein;all
479;b1093;0;12;12;25560.0137;protein;all
657;b3583;0;1;1;25560.5675;protein;all
1744;b2893;0;2;2;25621.3896;protein;all
771;b2747;0;1;1;25736.9594;protein;all
332;rsuA;1;1;2;25865;assembly;all
1077;b4384;0;7;7;25949.6409;protein;all
1100;b0171;0;2;2;25969.9802;protein;all
405;rpsC;0;1;1;25982.9;assembly;all
1175;b1465;0;1;1;26017.6247;protein;all
1009;b2024;0;1;1;26032.3222;protein;all
1326;b1252;0;1;1;26093.9289;protein;all
1698;b4055;0;17;17;26103.2148;protein;all
546;b4085;0;1;1;26108.9052;protein;all
1176;b1466;0;1;1;26160.2832;protein;all
1418;b0862;0;1;1;26216.8033;protein;all
870;b3844;0;6;6;26241.6868;protein;all
762;b0596;0;1;1;26249.3542;protein;all
1328;b3006;0;1;1;26287.0708;protein;all
1355;b3454;0;2;2;26309.9361;protein;all
859;b1606;0;1;1;26347.9972;protein;all
1394;b1281;0;1;1;26349.9521;protein;all
96;trnaleu;5;2;7;26382.8;RNA;all
866;b2564;0;1;1;26384.006;protein;all
797;b1992;0;1;1;26385.2981;protein;all
1182;b1226;0;1;1;26448.5338;protein;all
1479;b3040;0;6;6;26484.4801;protein;all
774;b2232;0;2;2;26555.1467;protein;all
348;rlmB;1;1;2;26556.3;assembly;all
1042;b1326;0;1;1;26557.6879;protein;all
1432;b0652;0;1;1;26660.8061;protein;all
1673;b0809;0;1;1;26730.6707;protein;all
406;rpsB;0;1;1;26743.3;assembly;all
1265;b0724;0;1;1;26769.6089;protein;all
1790;b3479;0;1;1;26820.1053;protein;all
1416;b0860;0;1;1;26829.1473;protein;all
1412;b2307;0;2;2;26869.4549;protein;all
1902;b0524;0;1;1;26893.8681;protein;all
816;b3991;0;1;1;26895.7856;protein;all
678;b2744;0;14;14;26900.1146;protein;all
1419;b0863;0;1;1;26929.2203;protein;all
820;b3992;0;1;1;26969.4899;protein;all
987;b3919;0;1;1;26971.5025;protein;all
338;rsmE;1;1;2;26977.8;assembly;all
1351;b2476;0;1;1;26994.6927;protein;all
1793;b0751;0;1;1;26995.9294;protein;all
1420;b0864;0;1;1;27021.7413;protein;all
1322;b1709;0;1;1;27080.8734;protein;all
727;b4153;0;1;1;27122.7968;protein;all
1150;b3831;0;1;1;27158.7802;protein;all
698;b3959;0;1;1;27159.2235;protein;all
1675;b0811;0;1;1;27189.7636;protein;all
1692;b3875;0;1;1;27199.9382;protein;all
965;b1539;0;3;3;27248.6187;protein;all
1021;b1778 * b3781;1;1;2;27257.4985;assembly;all
789;b2104;0;1;1;27338.8726;protein;all
1773;b0763;0;1;1;27363.8671;protein;all
92;trnahis;5;2;7;27374.2;RNA;all
105;trnatyr;5;2;7;27374.2;RNA;all
528;b3126;0;1;1;27383.8047;protein;all
520;b3385;0;1;1;27388.83;protein;all
955;b3449;0;5;5;27409.2672;protein;all
944;b3018;0;7;7;27452.8337;protein;all
1703;b3625;0;1;1;27460.6145;protein;all
1546;b1693;0;1;1;27466.3389;protein;all
1745;b0604;0;2;2;27494.6726;protein;all
1434;b0654;0;1;1;27502.3631;protein;all
527;b4266;0;1;1;27562.3903;protein;all
1163;b0974;0;1;1;27596.9926;protein;all
842;b0918;0;1;1;27614.1142;protein;all
1283;b1818;0;1;1;27635.4759;protein;all
1914;b1859;0;1;1;27728.3413;protein;all
508;b4381;0;1;1;27733.4812;protein;all
1465;b0933;0;1;1;27737.7691;protein;all
1105;b3924;0;4;4;27750.6101;protein;all
895;b3804;0;1;1;27797.6068;protein;all
646;b2705;0;1;1;27857.5543;protein;all
566;b1288;0;24;24;27863.6361;protein;all
1913;b1858;0;1;1;27867.1358;protein;all
1805;b2199;0;1;1;27885.0063;protein;all
1289;b4311;0;1;1;27887.6746;protein;all
1281;b3794;0;1;1;27927.8424;protein;all
914;b2762;0;6;6;27975.4669;protein;all
1414;b2310;0;1;1;27991.3077;protein;all
1168;b2719;0;1;1;27998.8463;protein;all
602;b1298;0;1;1;28012.6957;protein;all
767;b3833;0;2;2;28072.8892;protein;all
630;b0181;0;1;1;28079.6653;protein;all
1449;b2489;0;1;1;28100.9812;protein;all
686;b0386;0;1;1;28144.5888;protein;all
1246;b0036;0;2;2;28189.8954;protein;all
1611;b4287;0;1;1;28190.3591;protein;all
513;b0902;0;2;2;28203.9893;protein;all
780;b0134;0;1;1;28237.1171;protein;all
1470;b0366;0;1;1;28296.3995;protein;all
557;b3374;0;1;1;28331.5156;protein;all
1356;b3455;0;2;2;28426.5151;protein;all
1030;b0212;0;1;1;28434.035;protein;all
877;b0174;0;1;1;28443.7984;protein;all
951;b3918;0;7;7;28450.4355;protein;all
1004;b2025;0;1;1;28454.1145;protein;all
1708;b2309;0;1;1;28483.0206;protein;all
571;b2541;0;2;2;28499.269;protein;all
972;b0755;0;1;1;28556.0283;protein;all
1794;b3367;0;1;1;28562.1842;protein;all
785;b2103;0;2;2;28633.2815;protein;all
1411;b2306;0;2;2;28652.6981;protein;all
1833;b1443;0;1;1;28721.5183;protein;all
1549;b1260;0;1;1;28723.8089;protein;all
1462;b0031;0;1;1;28756.2878;protein;all
1407;b0151;0;1;1;28886.0953;protein;all
621;b0350;0;1;1;28889.5426;protein;all
1466;b0934;0;1;1;28925.0817;protein;all
1573;b1519;0;1;1;29005.6121;protein;all
957;b1278;0;30;30;29020.8837;protein;all
1812;b3725;0;1;1;29026.9566;protein;all
1826;b1124;0;1;1;29110.6009;protein;all
101;trnaser;5;2;7;29138.3;RNA;all
948;b2533;0;1;1;29171.7701;protein;all
612;b2919;0;1;1;29172.2498;protein;all
624;b1897;0;1;1;29174.9351;protein;all
902;b3607;0;1;1;29316.3044;protein;all
1321;b0158;0;1;1;29366.4592;protein;all
625;b0508;0;1;1;29377.1086;protein;all
1547;b3281;0;1;1;29413.2785;protein;all
1762;b0197;0;1;1;29431.2573;protein;all
496;b0207;0;2;2;29436.4224;protein;all
1589;b2480 * b3781;1;1;2;29440.2132;assembly;all
536;b3222;0;1;1;29643.5125;protein;all
891;b3996;0;1;1;29688.6063;protein;all
784;b1096;0;1;1;29714.75;protein;all
1791;b3480;0;1;1;29721.3165;protein;all
1016;b3057;0;2;2;29758.4214;protein;all
601;b0678;0;1;1;29773.8698;protein;all
738;b0729;0;1;1;29777.135;protein;all
1679;b3927;0;3;3;29779.6309;protein;all
1618;b0588;0;1;1;29783.762;protein;all
1471;b0367;0;1;1;29811.5386;protein;all
1133;b2407;0;5;5;29834.297;protein;all
371;rplB;0;1;1;29860.1;assembly;all
1497;b0166;0;1;1;29891.7343;protein;all
1756;b2328;0;4;4;30136.3324;protein;all
652;b3902;0;1;1;30145.1376;protein;all
1463;b3809;0;1;1;30208.2312;protein;all
1779;b2424;0;2;2;30291.4679;protein;all
1292;b3738;0;1;1;30302.8738;protein;all
1789;b3478;0;1;1;30361.6091;protein;all
769;b0446;0;1;1;30370.5957;protein;all
703;b0120;0;1;1;30384.3065;protein;all
1116;b2781;0;8;8;30411.9517;protein;all
587;b0822;0;5;5;30412.4561;protein;all
342;rrmA;1;1;2;30418.6;assembly;all
339;rsmA;0;1;1;30419.8;assembly;all
471;efts;1;1;2;30422.6;protein;all
510;b3125;0;1;1;30427.1152;protein;all
1138;b2827;0;1;1;30479.3304;protein;all
1250;b1590;0;1;1;30523.3185;protein;all
1823;b0857;0;1;1;30540.2277;protein;all
1635;b2492;0;2;2;30564.3034;protein;all
783;b3177;0;1;1;30614.7663;protein;all
825;b1740;0;1;1;30636.4576;protein;all
509;b0509;0;1;1;30800.2365;protein;all
994;b1773;0;1;1;30809.441;protein;all
909;b2521;0;1;1;30811.4488;protein;all
663;b2096;0;1;1;30811.5764;protein;all
1225;b0896;0;1;1;30825.8818;protein;all
1050;b1215;0;1;1;30832.3438;protein;all
786;b2418;0;4;4;30847.0162;protein;all
1702;b3630;0;1;1;30871.9654;protein;all
787;b1208;0;1;1;30925.0009;protein;all
1848;b3751;0;1;1;30950.1033;protein;all
1284;b1819;0;1;1;30955.1144;protein;all
1028;b1781;0;1;1;30986.2602;protein;all
1634;b0904;0;2;2;30990.3958;protein;all
1126;b3967;0;1;1;31001.5805;protein;all
1020;b1778 * b2582;1;1;2;31005.6215;assembly;all
932;b0529;0;2;2;31043.3754;protein;all
1827;b1125;0;1;1;31061.6068;protein;all
497;b3012;0;2;2;31109.2429;protein;all
1711;b0813;0;2;2;31168.089;protein;all
650;b4474;0;1;1;31168.5198;protein;all
1548;b1692;0;1;1;31227.4546;protein;all
899;b2154;0;1;1;31258.9278;protein;all
1492;b2478;0;1;1;31269.6246;protein;all
660;b3137;0;1;1;31293.3209;protein;all
1092;b0049;0;3;3;31296.348;protein;all
844;b1636;0;1;1;31321.8421;protein;all
499;b3693;0;1;1;31373.2117;protein;all
1700;b2435;0;2;2;31411.7283;protein;all
900;b0355;0;1;1;31424.1147;protein;all
953;b0175;0;7;7;31453.3805;protein;all
1644;b3451;0;1;1;31499.3612;protein;all
1125;b2143;0;2;2;31539.4985;protein;all
1147;b2867;0;1;1;31556.4352;protein;all
1296;b3733;0;1;1;31577.0736;protein;all
803;b0133;0;1;1;31597.307;protein;all
898;b2262;0;1;1;31632.7585;protein;all
1574;b0521;0;1;1;31643.7491;protein;all
826;b0613;0;1;1;31644.0952;protein;all
1119;b2440;0;1;1;31781.2506;protein;all
1070;b2204;0;1;1;31873.1977;protein;all
327;prmA;1;1;2;31876.7;protein;all
927;b1232;0;1;1;31934.3405;protein;all
613;b0349;0;2;2;31937.101;protein;all
1606;b0452;0;10;10;31965.9186;protein;all
1369;b1485;0;1;1;31970.5441;protein;all
671;b4197;0;1;1;32006.2759;protein;all
637;b0331;0;1;1;32134.2898;protein;all
863;b0421;0;2;2;32159.262;protein;all
1238;b4032;0;1;1;32225.0092;protein;all
1307;b1475;0;1;1;32238.4062;protein;all
878;b0428;0;1;1;32248.1095;protein;all
1553;b1463;0;1;1;32274.1882;protein;all
567;b3752;0;1;1;32290.1086;protein;all
1363;b3542;0;1;1;32308.0877;protein;all
704;b0121;0;1;1;32321.0159;protein;all
1813;b3726;0;1;1;32321.4109;protein;all
1304;b1533;0;2;2;32323.807;protein;all
752;b3236;0;1;1;32336.8967;protein;all
845;b1106;0;1;1;32396.8876;protein;all
542;b0368;0;1;1;32409.0878;protein;all
644;b1092;0;1;1;32416.847;protein;all
1438;b3952;0;1;1;32429.3119;protein;all
310;rimK;1;1;2;32436.1;protein;all
978;b1723;0;1;1;32455.6075;protein;all
556;b0394;0;1;1;32499.3744;protein;all
788;b4040;0;1;1;32511.3528;protein;all
1778;b2423;0;2;2;32537.1902;protein;all
889;b0595;0;1;1;32553.9812;protein;all
540;b0030;0;5;5;32560.4143;protein;all
841;b2615;0;1;1;32565.9952;protein;all
538;b3225;0;1;1;32593.0813;protein;all
1483;b2131;0;1;1;32608.8762;protein;all
903;b2421;0;1;1;32663.8028;protein;all
838;b2039;0;1;1;32693.1704;protein;all
481;b2040;0;1;1;32693.7253;protein;all
665;b3061;0;1;1;32733.1975;protein;all
839;b3789;0;1;1;32733.9908;protein;all
759;b0109;0;1;1;32761.6613;protein;all
1210;b0092;0;1;1;32839.329;protein;all
937;b0485;0;1;1;32902.9412;protein;all
1384;b4088;0;1;1;32909.5082;protein;all
1772;b3624;0;1;1;32919.6994;protein;all
1478;b3915;0;7;7;32926.8736;protein;all
848;b1236;0;1;1;32941.8982;protein;all
1358;b3457;0;2;2;32981.9155;protein;all
1408;b0152;0;1;1;32997.955;protein;all
1045;b1245;0;2;2;33021.5363;protein;all
1171;b2722;0;1;1;33028.953;protein;all
1034;b1119;0;1;1;33042.2969;protein;all
1576;b2874;0;1;1;33070.5803;protein;all
1311;b3893;0;1;1;33100.0478;protein;all
926;b3941;0;1;1;33102.3431;protein;all
741;b0616;0;1;1;33109.2624;protein;all
1614;b4290;0;1;1;33145.936;protein;all
1767;b3821;0;42;42;33162.7137;protein;all
1588;b2480 * b2582;1;1;2;33188.3362;assembly;all
1687;b0832;0;1;1;33237.8533;protein;all
1645;b3452;0;1;1;33263.4502;protein;all
1230;b2316;0;1;1;33321.5612;protein;all
1857;b2703;0;1;1;33331.6273;protein;all
1000;b2019;0;1;1;33366.3654;protein;all
487;b0828;0;1;1;33393.6294;protein;all
1435;b0655;0;1;1;33419.7698;protein;all
1012;b0261;0;2;2;33422.4289;protein;all
1400;b0351;0;1;1;33442.1061;protein;all
1044;b1244;0;2;2;33442.7972;protein;all
1847;b3750;0;1;1;33451.4119;protein;all
642;b1091;0;2;2;33514.7413;protein;all
938;b1524;0;1;1;33515.2165;protein;all
701;b2937;0;1;1;33556.6639;protein;all
1038;b1192;0;4;4;33567.0666;protein;all
1320;b0411;0;7;7;33588.587;protein;all
860;b3930;0;1;1;33593.5731;protein;all
1493;b0003;0;1;1;33623.2905;protein;all
1543;b3909;0;2;2;33668.8736;protein;all
577;b2162;0;2;2;33747.6512;protein;all
554;b2168;0;1;1;33755.291;protein;all
1912;b1857;0;1;1;33776.9628;protein;all
467;era;0;1;1;33809.7;assembly;all
544;b4084;0;1;1;33820.571;protein;all
578;b0651;0;2;2;33822.5211;protein;all
888;b3805;0;1;1;33851.4377;protein;all
765;b0425;0;1;1;33870.3756;protein;all
1620;b0590;0;1;1;33870.9031;protein;all
1757;b2134;0;4;4;33887.0339;protein;all
1575;b0323;0;1;1;33930.4529;protein;all
1896;b0096;0;1;1;33955.5271;protein;all
498;b3526;0;1;1;33961.9614;protein;all
653;b2708;0;1;1;34031.0703;protein;all
1686;b0831;0;1;1;34066.015;protein;all
1555;b3770;0;4;4;34093.2439;protein;all
1814;b3727;0;1;1;34120.5973;protein;all
1612;b4288;0;1;1;34131.1031;protein;all
1498;b3288;0;1;1;34168.0639;protein;all
586;b0348;0;2;2;34195.637;protein;all
1403;b4460;0;1;1;34210.5231;protein;all
1001;b1207;0;1;1;34217.885;protein;all
409;era * gdp;1;1;2;34252.7;assembly;all
1469;b0365;0;1;1;34265.6565;protein;all
1621;b0592;0;1;1;34282.6313;protein;all
1382;b4086;0;1;1;34315.2451;protein;all
856;b2436;0;1;1;34322.2093;protein;all
392;era * gtp;2;1;3;34332.7;assembly;all
1840;b4227;0;1;1;34344.2546;protein;all
1443;b2483;0;1;1;34358.8478;protein;all
1832;b1442;0;1;1;34359.652;protein;all
1481;b2129;0;1;1;34424.1063;protein;all
1374;b4245;0;1;1;34426.9462;protein;all
904;b2414;0;1;1;34489.2242;protein;all
1467;b0936;0;1;1;34557.2953;protein;all
1367;b1483;0;1;1;34620.5303;protein;all
1253;b0888;0;1;1;34622.6365;protein;all
1040;b1325;0;1;1;34673.6285;protein;all
1477;b0752;0;5;5;34678.0087;protein;all
980;b2388;0;1;1;34722.6705;protein;all
828;b0025;0;2;2;34733.8411;protein;all
1475;b3196;0;1;1;34740.1755;protein;all
1516;b3560;0;1;1;34773.975;protein;all
887;b0029;0;2;2;34774.1472;protein;all
569;b3916;0;2;2;34841.6643;protein;all
1613;b4289;0;1;1;34892.3028;protein;all
1130;b3619;0;1;1;34892.7321;protein;all
1619;b0589;0;1;1;34909.7974;protein;all
1191;b0432;0;1;1;34910.8975;protein;all
1693;b1319;0;1;1;34912.8303;protein;all
1323;b1711;0;1;1;34948.8956;protein;all
1842;b4231;0;1;1;34977.2338;protein;all
322;prmB;1;1;2;35001.3;protein;all
1056;b4073;0;1;1;35041.7937;protein;all
963;b4388;0;1;1;35042.2922;protein;all
1282;b1817;0;1;1;35047.132;protein;all
846;b0417;0;1;1;35070.4423;protein;all
865;b0052;0;1;1;35113.36;protein;all
1024;b3781 * b4219;1;1;2;35121.2567;assembly;all
910;b1919;0;1;1;35152.8887;protein;all
907;b2752;0;1;1;35187.9047;protein;all
654;b3197;0;1;1;35195.7353;protein;all
876;b3187;0;1;1;35216.5802;protein;all
1338;b0008;0;1;1;35218.8107;protein;all
1897;b3117;0;1;1;35232.0188;protein;all
1229;b0185;0;1;1;35241.1323;protein;all
1788;b3477;0;1;1;35247.6915;protein;all
610;b1033;0;4;4;35342.9845;protein;all
1440;b1478;0;1;1;35379.1794;protein;all
495;b3553;0;10;10;35395.0992;protein;all
1598;b1054;0;1;1;35406.4492;protein;all
779;b2261;0;1;1;35476.1909;protein;all
1822;b0856;0;1;1;35489.0856;protein;all
1600;b2378;0;1;1;35493.0174;protein;all
995;b1779;0;1;1;35532.0683;protein;all
1402;b1901;0;1;1;35540.4878;protein;all
1704;b3621;0;1;1;35543.3343;protein;all
1648;b2148;0;1;1;35549.7172;protein;all
831;b2947;0;1;1;35560.4876;protein;all
772;b0915;0;1;1;35588.8594;protein;all
754;b0369;0;1;1;35624.4192;protein;all
1337;b2464;0;1;1;35658.3625;protein;all
1841;b4230;0;1;1;35658.5409;protein;all
1650;b2150;0;1;1;35712.1395;protein;all
1018;b4013;0;1;1;35726.8399;protein;all
1903;b3566;0;1;1;35733.6006;protein;all
724;b1744;0;1;1;35799.751;protein;all
1362;b3541;0;1;1;35843.9731;protein;all
991;b3925;0;1;1;35851.9245;protein;all
874;b0475;0;1;1;35883.9654;protein;all
956;b4160;0;7;7;35933.9708;protein;all
697;b3958;0;1;1;35951.6921;protein;all
1910;b3579;0;1;1;35969.6455;protein;all
1511;b2679;0;1;1;36022.1015;protein;all
345;rluC;1;1;2;36026.1;assembly;all
1891;b0179;0;1;1;36038.1064;protein;all
1425;b2458;0;1;1;36066.3228;protein;all
1368;b1484;0;1;1;36099.4597;protein;all
1663;b2052;0;2;2;36140.7144;protein;all
1876;b0068;0;1;1;36162.9585;protein;all
1201;b2282;0;1;1;36218.7257;protein;all
1334;b0767;0;1;1;36307.204;protein;all
1899;b2254;0;1;1;36338.7235;protein;all
843;b3974;0;1;1;36359.3127;protein;all
609;b3608;0;1;1;36361.1934;protein;all
1076;b1623;0;2;2;36397.0238;protein;all
1079;b2676;0;1;1;36442.7927;protein;all
598;b4358;0;1;1;36447.4627;protein;all
1797;b2027;0;1;1;36454.2968;protein;all
525;b0352;0;1;1;36470.0408;protein;all
804;b0870;0;4;4;36494.2942;protein;all
1461;b1380;0;1;1;36534.3789;protein;all
493;b3575;0;1;1;36572.3266;protein;all
1504;b3816;0;3;3;36589.265;protein;all
489;b3744;0;1;1;36650.101;protein;all
1780;b3917;0;1;1;36658.8275;protein;all
1577;b1764;0;1;1;36686.8601;protein;all
632;b0181 * b1094;1;1;2;36719.0818;assembly;all
1839;b3629;0;1;1;36730.0155;protein;all
1391;b0945;0;2;2;36774.0758;protein;all
712;b0273;0;1;1;36826.7447;protein;all
1529;b1714;0;1;1;36831.3634;protein;all
990;b4232;0;1;1;36833.4917;protein;all
1714;b2957;0;2;2;36850.2459;protein;all
1381;b2499;0;1;1;36853.6207;protein;all
711;b4254;0;1;1;36906.697;protein;all
862;b1991;0;1;1;36986.5916;protein;all
1815;b3728;0;1;1;37023.429;protein;all
1831;b1441;0;1;1;37040.1696;protein;all
921;b2762 * b3610;1;1;2;37112.8655;assembly;all
346;rluD;1;1;2;37121.2;assembly;all
486;b1767;0;1;1;37126.8016;protein;all
526;b4267;0;2;2;37146.2152;protein;all
1046;b1246;0;2;2;37188.0662;protein;all
1047;b1247;0;2;2;37197.1262;protein;all
1694;b0957;0;1;1;37200.3005;protein;all
380;rRNA5S;0;1;1;37213.6;RNA;all
964;b3616;0;1;1;37238.6448;protein;all
668;b0759;0;1;1;37264.6652;protein;all
868;b2927;0;1;1;37298.934;protein;all
1750;b3907;0;2;2;37319.3743;protein;all
1370;b1486;0;1;1;37344.5498;protein;all
1393;b0104;0;1;1;37383.2577;protein;all
599;b2091;0;1;1;37389.704;protein;all
1599;b1855;0;2;2;37409.9518;protein;all
1538;b3384;0;1;1;37437.3843;protein;all
1364;b3543;0;1;1;37496.5293;protein;all
1361;b3540;0;1;1;37560.0179;protein;all
1036;b1107;0;3;3;37594.317;protein;all
1782;b2425;0;1;1;37614.0854;protein;all
1510;b2678;0;1;1;37619.2387;protein;all
336;rsmC;1;1;2;37624.3;assembly;all
915;b0849 * b2762;1;1;2;37660.2041;assembly;all
1725;b1291;0;2;2;37660.2848;protein;all
1802;b2034;0;1;1;37756.7668;protein;all
1764;b0199;0;1;1;37787.9287;protein;all
1893;b0090;0;1;1;37814.2744;protein;all
485;b3972;0;1;1;37850.5691;protein;all
647;b0517;0;1;1;37966.6857;protein;all
1564;b0754;0;1;1;38009.0917;protein;all
992;b2097;0;1;1;38108.7504;protein;all
1748;b0756;0;1;1;38189.984;protein;all
581;b1200;0;1;1;38214.766;protein;all
857;b0750;0;1;1;38240.3907;protein;all
505;b4468;0;1;1;38360.5511;protein;all
706;b1747;0;1;1;38455.4236;protein;all
590;b3371;0;1;1;38568.781;protein;all
807;b0775;0;1;1;38647.6888;protein;all
608;b3945;0;3;3;38711.7471;protein;all
1706;b3632;0;1;1;38730.219;protein;all
999;b0514;0;1;1;38734.0663;protein;all
1565;b1704;0;1;1;38734.6239;protein;all
1563;b2601;0;1;1;38803.5416;protein;all
1390;b1062;0;1;1;38826.9433;protein;all
1029;b3001;0;1;1;38831.7045;protein;all
484;b1190;0;1;1;38844.1808;protein;all
1825;b1123;0;1;1;38866.6028;protein;all
1023;b2582 * b4219;1;1;2;38869.3797;assembly;all
1545;b3389;0;1;1;38880.5391;protein;all
1234;b0241;0;248;248;38921.5191;protein;all
947;b3825;0;35;35;38977.7818;protein;all
1672;b3626;0;1;1;39039.8599;protein;all
1705;b3620;0;1;1;39041.6864;protein;all
709;b0242;0;1;1;39056.0532;protein;all
1359;b3460;0;1;1;39075.9245;protein;all
1775;b0765;0;1;1;39101.9391;protein;all
961;b3124;0;1;1;39103.8837;protein;all
1552;b2329;0;1;1;39136.9935;protein;all
993;b2925;0;1;1;39146.7931;protein;all
483;b4053;0;1;1;39152.4927;protein;all
1473;b1216;0;3;3;39167.9849;protein;all
1115;b4161;0;4;4;39192.8379;protein;all
761;b3997;0;1;1;39247.6756;protein;all
1209;b0381;0;1;1;39315.3295;protein;all
1235;b0929;0;249;249;39332.7982;protein;all
607;b0356;0;3;3;39358.5544;protein;all
1006;b2021;0;1;1;39359.6687;protein;all
1740;b3458;0;1;1;39378.2231;protein;all
1671;b3627;0;1;1;39422.7038;protein;all
1353;b0522;0;1;1;39460.6393;protein;all
1594;b3785;0;1;1;39488.6547;protein;all
1039;b1640;0;1;1;39495.8109;protein;all
1885;b0073;0;2;2;39516.5592;protein;all
1643;b3450;0;1;1;39523.2211;protein;all
595;b0758;0;1;1;39645.2079;protein;all
1638;b2169;0;1;1;39647.3473;protein;all
1166;b2997;0;1;1;39651.5833;protein;all
1097;b3788;0;1;1;39753.3569;protein;all
925;b2762 * b3781;1;1;2;39781.9488;assembly;all
882;b0907;0;2;2;39782.8424;protein;all
849;b0087;0;1;1;39874.2484;protein;all
1490;b3433;0;1;1;40017.4244;protein;all
551;b4192;0;1;1;40060.1996;protein;all
1854;b2963;0;4;4;40112.0151;protein;all
930;b2905;0;1;1;40146.2466;protein;all
1460;b1064 * b3503;1;1;2;40203.0446;assembly;all
1852;b2701;0;4;4;40255.2532;protein;all
1002;b2022;0;2;2;40277.5142;protein;all
1276;b1873;0;1;1;40285.9907;protein;all
627;b1800;0;1;1;40314.4676;protein;all
764;b0414;0;2;2;40337.855;protein;all
688;b2224;0;1;1;40352.03;protein;all
1237;b2215;0;249;249;40367.5898;protein;all
1851;b2813;0;4;4;40410.1213;protein;all
611;b2799;0;1;1;40512.904;protein;all
2;rf1;2;2;4;40516.8;protein;all
1098;b2041;0;1;1;40557.8119;protein;all
1260;b4481;0;1;1;40639.0922;protein;all
1161;b0972;0;1;1;40680.94;protein;all
773;b2515;0;1;1;40683.1339;protein;all
1656;b3628;0;1;1;40825.4417;protein;all
1820;b0854;0;1;1;40839.1607;protein;all
1747;b2239;0;5;5;40842.8745;protein;all
919;b1654 * b2762;1;1;2;40854.0836;assembly;all
639;b3845;0;8;8;40875.8029;protein;all
962;b1059;0;2;2;40901.4961;protein;all
535;b0677;0;1;1;40948.6267;protein;all
1269;b3784;0;1;1;40956.7547;protein;all
1241;b4035;0;1;1;40989.968;protein;all
1905;b3568;0;1;1;41030.3694;protein;all
1316;b0837;0;1;1;41053.9644;protein;all
645;b1092 * b1094;1;1;2;41056.2635;assembly;all
1777;b2422;0;2;2;41058.3945;protein;all
974;b2926;0;1;1;41117.7094;protein;all
1482;b2130;0;1;1;41138.0567;protein;all
641;b3600;0;1;1;41138.5077;protein;all
1236;b1377;0;248;248;41219.3433;protein;all
75;rf2;2;2;4;41250.2;protein;all
1496;b2472;0;1;1;41268.5357;protein;all
1716;b3265;0;1;1;41317.1584;protein;all
1785;b0019;0;1;1;41355.1815;protein;all
1531;b0341;0;1;1;41360.2142;protein;all
790;b2320;0;1;1;41367.137;protein;all
737;b0728;0;1;1;41392.1542;protein;all
1062;b2711;0;1;1;41403.1115;protein;all
682;b0032;0;1;1;41430.5103;protein;all
559;b0757;0;1;1;41441.6415;protein;all
1014;b3939;0;1;1;41549.8972;protein;all
1696;b0353;0;2;2;41550.2941;protein;all
1819;b2536;0;1;1;41592.2265;protein;all
806;b0776;0;1;1;41593.7742;protein;all
1244;b2835;0;21;21;41655.1076;protein;all
1707;b3623;0;1;1;41728.9255;protein;all
1608;b0935;0;5;5;41735.7312;protein;all
746;b3791;0;1;1;41900.5557;protein;all
1821;b0855;0;1;1;41930.2403;protein;all
1013;b2942;0;1;1;41951.132;protein;all
344;rumB;1;1;2;41955.3;assembly;all
1562;b2600;0;2;2;42042.02;protein;all
1099;b2053;0;1;1;42046.3249;protein;all
468;rsgA;0;1;1;42120;assembly;all
643;b1091 * b1094;1;1;2;42154.1578;assembly;all
1895;b2253;0;1;1;42237.0459;protein;all
1129;b3786;0;1;1;42244.093;protein;all
1670;b3631;0;1;1;42283.6126;protein;all
776;b2907;0;1;1;42287.7962;protein;all
1830;b1440;0;1;1;42294.6867;protein;all
696;b3957;0;2;2;42346.8451;protein;all
692;b0182;0;1;1;42381.9724;protein;all
1156;b0979;0;1;1;42423.342;protein;all
1678;b3653;0;1;1;42424.6348;protein;all
1380;b1849;0;2;2;42433.1807;protein;all
1159;b0734;0;1;1;42452.6235;protein;all
597;b4478;0;1;1;42522.3821;protein;all
1406;b1528;0;3;3;42537.6961;protein;all
408;gdp * rsgA;1;1;2;42563;assembly;all
669;b2323;0;12;12;42612.8728;protein;all
403;gtp * rsgA;2;1;3;42643;assembly;all
1738;b0070;0;1;1;42712.727;protein;all
1258;b3605;0;2;2;42727.7068;protein;all
1737;b2170;0;1;1;42745.5886;protein;all
1890;b1907;0;1;1;42818.5959;protein;all
634;b1613;0;1;1;42849.4195;protein;all
855;b0593;0;1;1;42931.1288;protein;all
775;b0662;0;1;1;42952.9913;protein;all
756;b3803;0;1;1;42962.4918;protein;all
1142;b2036;0;1;1;42965.3292;protein;all
1550;b1261;0;1;1;42982.5358;protein;all
1828;b1126;0;1;1;43027.7235;protein;all
670;b1095;0;9;9;43045.2834;protein;all
620;b0333;0;1;1;43101.6668;protein;all
1561;b2599;0;2;2;43110.836;protein;all
960;b3617;0;1;1;43116.5547;protein;all
1803;b2032;0;1;1;43187.6168;protein;all
6;peptide;160;0;160;43200;placeholder;all
912;b3008;0;2;2;43211.8738;protein;all
901;b2810;0;1;1;43233.6609;protein;all
1592;b1185 * b3860;1;1;2;43246.2296;assembly;all
1632;b0591;0;1;1;43281.4464;protein;all
462;eftu;0;1;1;43283;protein;all
1398;b2296;0;1;1;43289.9501;protein;all
815;b3990;0;1;1;43319.6251;protein;all
492;b2871;0;1;1;43327.0851;protein;all
1761;b2010;0;5;5;43345.5345;protein;all
541;b3115;0;2;2;43383.6187;protein;all
1240;b4034;0;1;1;43387.0886;protein;all
864;b0173;0;1;1;43387.5375;protein;all
791;b3639;0;2;2;43437.6443;protein;all
1318;b2393;0;7;7;43475.2328;protein;all
1862;b3089;0;2;2;43477.1944;protein;all
1086;b2235;0;1;1;43516.7509;protein;all
923;b2582 * b2762;1;1;2;43530.0718;assembly;all
1554;b4054;0;3;3;43537.2948;protein;all
480;b0928;0;3;3;43572.8376;protein;all
1278;b0996;0;1;1;43606.0714;protein;all
1760;b0839;0;5;5;43608.3764;protein;all
1015;b1622;0;1;1;43641.3564;protein;all
1525;b0336;0;1;1;43649.0677;protein;all
494;b2028;0;1;1;43656.3516;protein;all
700;b1748;0;2;2;43664.8446;protein;all
115;eftu * gdp;400;1;401;43726;assembly;all
699;b3359;0;2;2;43766.4533;protein;all
106;eftu * gtp;2;20;22;43806;assembly;all
1064;b2552;0;2;2;43867.1171;protein;all
942;b1661;0;4;4;43908.5106;protein;all
575;b2542;0;1;1;43977.6943;protein;all
735;b0727;0;1;1;44010.8749;protein;all
1219;b2243;0;1;1;44107.5672;protein;all
1502;b1592;0;1;1;44152.8533;protein;all
1509;b2677;0;1;1;44162.2825;protein;all
959;b2913;0;1;1;44175.2478;protein;all
1610;b2392;0;2;2;44193.1331;protein;all
1348;b0574;0;1;1;44304.3514;protein;all
1733;b0842;0;2;2;44320.4178;protein;all
1719;b3161;0;2;2;44332.0169;protein;all
507;b4383;0;2;2;44369.4379;protein;all
1759;b0632;0;5;5;44443.4377;protein;all
1786;b0451;0;1;1;44514.1721;protein;all
651;b3380;0;1;1;44558.99;protein;all
713;b0243;0;1;1;44629.5476;protein;all
690;b1302;0;1;1;44728.5441;protein;all
1798;b2035;0;1;1;44743.7628;protein;all
723;b3189;0;1;1;44817.1296;protein;all
636;b4322;0;1;1;44837.4956;protein;all
1597;b3792;0;1;1;44959.0823;protein;all
1900;b2497;0;1;1;45059.5717;protein;all
819;b2530;0;1;1;45088.9943;protein;all
504;b4467;0;1;1;45109.6448;protein;all
1245;b0038;0;2;2;45126.2532;protein;all
1889;b3709;0;1;1;45210.0993;protein;all
805;b2551;0;5;5;45316.0548;protein;all
1218;b2242;0;1;1;45356.71;protein;all
881;b0154;0;1;1;45365.6295;protein;all
1909;b3578;0;1;1;45367.632;protein;all
1801;b2037;0;1;1;45382.0419;protein;all
824;b2315;0;1;1;45405.1343;protein;all
1455;b3528;0;6;6;45435.7319;protein;all
1431;b3502;0;1;1;45496.8568;protein;all
1901;b1006;0;1;1;45556.8723;protein;all
1701;b2817;0;2;2;45633.8873;protein;all
1601;b0585;0;2;2;45651.3786;protein;all
973;b2779;0;1;1;45654.4073;protein;all
1746;b1002;0;2;2;45682.3845;protein;all
545;b0516;0;1;1;45693.4865;protein;all
1456;b4138;0;5;5;45750.1607;protein;all
750;b1136;0;1;1;45756.1841;protein;all
689;b2662;0;1;1;45774.1064;protein;all
1892;b3787;0;1;1;45838.205;protein;all
840;b0931;0;1;1;45896.7234;protein;all
1389;b4005;0;1;1;45939.8369;protein;all
1666;b3415;0;1;1;45966.0853;protein;all
1259;b4265;0;3;3;46040.7278;protein;all
1731;b1250;0;1;1;46062.0321;protein;all
1568;b0908;0;1;1;46095.263;protein;all
1007;b2020;0;1;1;46109.799;protein;all
1319;b2406;0;6;6;46139.3104;protein;all
1464;b2838;0;1;1;46176.7066;protein;all
722;b2523;0;2;2;46179.6223;protein;all
1715;b0401;0;3;3;46208.1588;protein;all
1357;b3456;0;2;2;46268.7468;protein;all
883;b1210;0;1;1;46306.2721;protein;all
1317;b2964;0;11;11;46388.7172;protein;all
1667;b4476;0;1;1;46415.412;protein;all
531;b2221 * b2222;1;1;2;46485.3592;assembly;all
1835;b0692;0;2;2;46494.3452;protein;all
1739;b0343;0;1;1;46502.6956;protein;all
640;b2342;0;8;8;46529.9712;protein;all
1474;b4132;0;1;1;46664.5131;protein;all
478;b3572;0;1;1;46710.695;protein;all
1422;b4115;0;1;1;46842.0701;protein;all
1593;b3622;0;2;2;46877.0785;protein;all
1662;b3093;0;2;2;46891.7714;protein;all
1860;b2796;0;1;1;46905.789;protein;all
1216;b0088;0;1;1;46973.0941;protein;all
1518;b2514;0;1;1;47028.8824;protein;all
1354;b2587;0;1;1;47051.9662;protein;all
1607;b0980;0;2;2;47056.2735;protein;all
1653;b3691;0;1;1;47076.1471;protein;all
662;b2095;0;1;1;47108.176;protein;all
894;b0004;0;2;2;47113.2536;protein;all
1640;b4321;0;2;2;47137.3867;protein;all
1458;b4077;0;2;2;47158.5953;protein;all
603;b1301;0;1;1;47168.9902;protein;all
659;b3132;0;1;1;47191.8604;protein;all
626;b3903;0;2;2;47198.8751;protein;all
1139;b4382;0;2;2;47206.6012;protein;all
1771;b3633;0;2;2;47290.4705;protein;all
795;b0774;0;1;1;47335.1148;protein;all
558;b2045;0;1;1;47342.9875;protein;all
1378;b4177;0;1;1;47344.3824;protein;all
834;b4390;0;1;1;47345.2579;protein;all
1221;b1109;0;3;3;47358.1324;protein;all
1194;b0086;0;1;1;47446.5803;protein;all
1586;b2895 * b3924;1;1;2;47450.5615;assembly;all
1585;b0684 * b3924;1;1;2;47487.3092;assembly;all
679;b4015;0;1;1;47520.9986;protein;all
1539;b1637;0;1;1;47526.3942;protein;all
1268;b2223;0;3;3;47527.1876;protein;all
1141;b3176;0;1;1;47543.0352;protein;all
1641;b2801;0;1;1;47544.3402;protein;all
1636;b3370;0;2;2;47575.973;protein;all
1122;b0337;0;1;1;47590.4032;protein;all
482;b1189;0;1;1;47606.7473;protein;all
1604;b0789;0;7;7;47632.9148;protein;all
1866;b1981;0;1;1;47816.8149;protein;all
966;b2366;0;1;1;47900.0121;protein;all
1457;b4123;0;5;5;47934.6886;protein;all
1699;b4169;0;2;2;47984.6384;protein;all
730;b0720;0;1;1;48014.4729;protein;all
347;rlmD;1;1;2;48051.7;assembly;all
335;rsmB;1;1;2;48346.9;assembly;all
1642;b0621;0;2;2;48411.6703;protein;all
1536;b0893;0;2;2;48413.476;protein;all
1646;b3453;0;1;1;48448.1509;protein;all
1113;b0477;0;2;2;48448.2173;protein;all
967;b4471;0;1;1;48521.1389;protein;all
1489;b4024;0;1;1;48531.1434;protein;all
1542;b2344;0;7;7;48540.9635;protein;all
941;b1761;0;1;1;48580.831;protein;all
979;b3430;0;1;1;48697.1057;protein;all
1185;b1602;0;1;1;48722.4643;protein;all
969;b2797;0;2;2;48752.4229;protein;all
853;b2265;0;1;1;48763.9628;protein;all
884;b3500;0;1;1;48771.9472;protein;all
606;b2788;0;1;1;48849.0043;protein;all
1314;b3654;0;3;3;48867.4837;protein;all
1861;b3116;0;2;2;48878.4055;protein;all
968;b1814;0;2;2;48906.1351;protein;all
552;b1398;0;1;1;48952.3213;protein;all
1655;b3127;0;3;3;49008.6523;protein;all
605;b2787;0;1;1;49140.4462;protein;all
1654;b2789;0;3;3;49141.4991;protein;all
638;b3730;0;2;2;49189.4964;protein;all
694;b2818;0;1;1;49194.6058;protein;all
1203;b2284;0;1;1;49291.8928;protein;all
685;b1745;0;1;1;49297.965;protein;all
1232;b3256;0;1;1;49320.1891;protein;all
1120;b2441;0;1;1;49402.497;protein;all
1837;b0383;0;1;1;49437.9992;protein;all
1652;b4356;0;1;1;49439.9524;protein;all
1544;b1262;0;2;2;49491.724;protein;all
1423;b1605;0;1;1;49500.8848;protein;all
1059;b0512;0;1;1;49601.0646;protein;all
702;b3073;0;1;1;49660.8104;protein;all
1710;b0112;0;4;4;49689.5407;protein;all
1795;b1223;0;2;2;49692.8349;protein;all
604;b3565;0;2;2;49741.4142;protein;all
1286;b2429;0;1;1;49801.3459;protein;all
1041;b4233;0;2;2;49873.5565;protein;all
1872;b0072;0;1;1;49881.2923;protein;all
1796;b1469;0;1;1;49889.5403;protein;all
708;b3172;0;1;1;49897.8317;protein;all
1243;b4036;0;7;7;49911.6431;protein;all
757;b3368;0;3;3;49950.8154;protein;all
1005;b2023 * b2025;1;1;2;50106.7315;assembly;all
814;b2260;0;1;1;50184.0678;protein;all
1143;b2883;0;1;1;50243.6295;protein;all
1346;b0572;0;1;1;50268.9699;protein;all
1680;b2240;0;1;1;50309.811;protein;all
707;b3960;0;1;1;50317.6366;protein;all
1295;b3732;0;1;1;50324.8256;protein;all
1503;b0155;0;1;1;50348.1235;protein;all
1727;b3290;0;2;2;50367.17;protein;all
633;b2048;0;1;1;50461.9829;protein;all
749;b1611;0;1;1;50488.3345;protein;all
1768;b0260;0;1;1;50525.1973;protein;all
1605;b3666;0;4;4;50605.9889;protein;all
1541;b3591;0;1;1;50606.6002;protein;all
618;b4119;0;1;1;50656.5313;protein;all
1270;b1101;0;1;1;50675.9252;protein;all
1809;b0576;0;2;2;50676.6948;protein;all
733;b0116;0;3;3;50687.8792;protein;all
976;b1676;0;1;1;50728.8721;protein;all
1426;b4193;0;1;1;50736.9478;protein;all
691;b1444;0;1;1;50829.4048;protein;all
1836;b1296;0;1;1;50852.3875;protein;all
850;b1812;0;2;2;50968.9339;protein;all
1657;b2943;0;2;2;50981.917;protein;all
1682;b3052;0;2;2;51050.0078;protein;all
1267;b2663;0;1;1;51079.4886;protein;all
1887;b4240;0;1;1;51080.1455;protein;all
572;b2538;0;1;1;51108.6025;protein;all
975;b1854;0;1;1;51356.5887;protein;all
579;b1198;0;1;1;51448.0239;protein;all
1332;b2029;0;1;1;51480.6506;protein;all
1595;b3793;0;1;1;51516.6192;protein;all
1345;b1131;0;2;2;51542.1581;protein;all
1375;b4244 * b4245;1;1;2;51547.3802;assembly;all
1261;b3962;0;1;1;51559.8032;protein;all
1376;b4208;0;5;5;51659.0506;protein;all
1377;b0007;0;2;2;51662.291;protein;all
1405;b2841;0;1;1;51683.8767;protein;all
1817;b3258;0;1;1;51716.4075;protein;all
718;b2661;0;1;1;51719.4475;protein;all
1444;b2484;0;1;1;51753.9597;protein;all
1755;b3182;0;9;9;51797.7105;protein;all
936;b3870;0;1;1;51903.1659;protein;all
934;b3213;0;1;1;52014.7104;protein;all
1395;b2508;0;1;1;52021.8558;protein;all
1195;b2276;0;1;1;52043.4491;protein;all
1513;b0526;0;1;1;52201.5189;protein;all
555;b2803;0;1;1;52258.0801;protein;all
614;b1415;0;2;2;52272.1715;protein;all
917;b1064 * b2762;1;1;2;52325.3872;assembly;all
490;b4139;0;1;1;52355.5648;protein;all
1388;b0511;0;1;1;52455.4277;protein;all
906;b2751;0;1;1;52557.816;protein;all
1501;b0930;0;1;1;52569.7937;protein;all
570;b3564;0;2;2;52617.6442;protein;all
1758;b4120;0;1;1;52635.7703;protein;all
940;b1493;0;1;1;52667.535;protein;all
939;b3517;0;1;1;52684.5637;protein;all
755;b3867;0;1;1;52728.4125;protein;all
911;b3708;0;3;3;52772.8594;protein;all
952;b2585;0;7;7;52801.1363;protein;all
977;b3429;0;1;1;52821.7612;protein;all
1486;b1801;0;3;3;52880.5195;protein;all
1867;b3063;0;1;1;52905.7902;protein;all
1578;b0312;0;2;2;52910.5159;protein;all
720;b0237;0;3;3;52914.7747;protein;all
1729;b3849;0;1;1;52959.0813;protein;all
837;b2049;0;1;1;53015.6678;protein;all
717;b1746;0;1;1;53025.6779;protein;all
1491;b0612;0;1;1;53091.9208;protein;all
562;b1297;0;2;2;53176.5796;protein;all
337;rsmF;1;1;2;53226.9;assembly;all
1043;b0433;0;3;3;53244.5368;protein;all
1193;b0085;0;1;1;53342.9912;protein;all
1811;b3493;0;1;1;53388.416;protein;all
532;b1300;0;2;2;53417.9723;protein;all
1288;b3224;0;1;1;53550.592;protein;all
1749;b2156;0;1;1;53575.2399;protein;all
635;b4323;0;1;1;53579.589;protein;all
1907;b4031;0;1;1;53607.4082;protein;all
594;b1896;0;1;1;53610.4896;protein;all
1215;b0091;0;1;1;53625.3298;protein;all
619;b1385;0;1;1;53698.5016;protein;all
1053;b4070;0;1;1;53702.3342;protein;all
1810;b2987;0;1;1;53808.0925;protein;all
503;b2979;0;1;1;53811.0831;protein;all
832;b2400;0;1;1;53815.1;protein;all
649;b2920;0;1;1;53823.8245;protein;all
1726;b1363;0;1;1;53943.1232;protein;all
512;b0334;0;1;1;53951.1183;protein;all
600;b3092;0;2;2;53986.5704;protein;all
1091;b1982;0;1;1;53994.2327;protein;all
568;b3904;0;1;1;54068.4265;protein;all
766;b3774;0;3;3;54068.4274;protein;all
548;b3091;0;1;1;54092.4626;protein;all
1430;b1453;0;1;1;54232.4337;protein;all
1061;b2710;0;1;1;54233.576;protein;all
1818;b1015;0;2;2;54343.5177;protein;all
1186;b1603;0;1;1;54622.7965;protein;all
547;b1521;0;1;1;54807.6092;protein;all
1603;b1249;0;7;7;54821.7232;protein;all
1521;b4111;0;4;4;54845.1589;protein;all
880;b3779;0;1;1;54870.5027;protein;all
719;b4260;0;2;2;54879.205;protein;all
818;b0423;0;1;1;54972.4232;protein;all
1401;b1900;0;1;1;55017.588;protein;all
1846;b3749;0;1;1;55040.9799;protein;all
1677;b1492;0;1;1;55075.9979;protein;all
521;b3580;0;2;2;55154.2284;protein;all
740;b0615;0;1;1;55172.0798;protein;all
1297;b3734;0;1;1;55221.4083;protein;all
1843;b4485;0;1;1;55259.3533;protein;all
550;b2901;0;1;1;55360.1312;protein;all
667;b3061 * b3062;1;1;2;55412.4123;assembly;all
781;b3843;0;1;1;55603.0895;protein;all
1339;b1852;0;1;1;55703.7783;protein;all
1293;b3736 * b3737 * b3738;1;2;3;55822.6571;assembly;all
549;b0062;0;1;1;56073.3549;protein;all
970;b3612;0;1;1;56193.2416;protein;all
1898;b3772;0;1;1;56194.5798;protein;all
563;b3926;0;1;1;56230.1095;protein;all
533;b3588;0;2;2;56305.6913;protein;all
596;b3128;0;1;1;56400.9374;protein;all
1649;b2149;0;1;1;56414.6108;protein;all
1685;b0830;0;1;1;56469.5088;protein;all
1904;b3567;0;1;1;56469.7561;protein;all
1392;b2312;0;1;1;56487.3932;protein;all
1196;b2277;0;1;1;56523.8695;protein;all
539;b0123;0;2;2;56555.5463;protein;all
1522;b0040;0;2;2;56586.6199;protein;all
1668;b1621;0;1;1;56626.329;protein;all
491;b1927;0;1;1;56638.6894;protein;all
1784;b1186;0;1;1;56727.7178;protein;all
1383;b4087;0;1;1;56744.2576;protein;all
1252;b3426;0;1;1;56749.8374;protein;all
1446;b2486;0;1;1;56766.4942;protein;all
1556;b1263;0;2;2;56869.2708;protein;all
1239;b4033;0;1;1;57012.6925;protein;all
1689;b0657;0;1;1;57065.0926;protein;all
1886;b0074;0;1;1;57297.2413;protein;all
1343;b4006;0;2;2;57328.5567;protein;all
1559;b1264;0;1;1;57493.8178;protein;all
1637;b2167;0;1;1;57518.4742;protein;all
1523;b2890;0;1;1;57602.7406;protein;all
1371;b1487;0;1;1;57640.5001;protein;all
1524;b4129;0;1;1;57825.8878;protein;all
1155;b0978;0;1;1;57919.1659;protein;all
1181;b1225;0;1;1;58065.7884;protein;all
677;b2502;0;2;2;58135.2891;protein;all
1158;b0733;0;1;1;58204.3868;protein;all
823;b2688;0;1;1;58268.6149;protein;all
593;b0688;0;1;1;58360.2444;protein;all
1177;b1467;0;1;1;58557.2722;protein;all
1227;b0037;0;3;3;58558.4533;protein;all
1387;b2507;0;1;1;58678.5323;protein;all
1787;b3476;0;1;1;58718.2725;protein;all
1567;b2975;0;3;3;58919.417;protein;all
1217;b2241;0;1;1;58957.589;protein;all
763;b0594;0;1;1;59111.4352;protein;all
1566;b3603;0;3;3;59167.4396;protein;all
1723;b0698;0;1;1;59188.4175;protein;all
1305;b4067;0;2;2;59196.4039;protein;all
1134;b0160;0;2;2;59382.2185;protein;all
1875;b0067;0;1;1;59532.4599;protein;all
464;rf3;0;1;1;59573.4;protein;all
674;b3403;0;1;1;59642.7499;protein;all
1048;b1329;0;1;1;59899.437;protein;all
67;gdp * rf3;4;1;5;60016.4;assembly;all
45;gtp * rf3;2;84;86;60096.4;assembly;all
748;b4122;0;1;1;60104.6108;protein;all
751;b2210;0;2;2;60228.8987;protein;all
672;b4014;0;1;1;60272.8536;protein;all
1365;b3544;0;1;1;60292.9567;protein;all
747;b1612;0;1;1;60297.8667;protein;all
810;b2574;0;4;4;60336.7152;protein;all
1386;b2780;0;1;1;60373.4411;protein;all
1879;b3671;0;1;1;60439.91;protein;all
1697;b0480;0;17;17;60823.2391;protein;all
1051;b1243;0;1;1;60898.1604;protein;all
565;b0063;0;3;3;61088.7214;protein;all
802;b2264;0;2;2;61366.3073;protein;all
867;b0052 * b2564;1;1;2;61497.366;assembly;all
996;b4025;0;1;1;61529.0037;protein;all
1753;b3447;0;1;1;61767.2137;protein;all
1582;b4136;0;4;4;61794.3441;protein;all
1114;b0650;0;1;1;61985.5411;protein;all
1256;b0871;0;1;1;62010.6986;protein;all
1720;b3679;0;1;1;62084.2046;protein;all
524;b0347;0;2;2;62184.9812;protein;all
1153;b1805;0;10;10;62331.2346;protein;all
1165;b2994;0;1;1;62490.4046;protein;all
1736;b2257;0;1;1;62541.7688;protein;all
488;b0674;0;1;1;62658.2816;protein;all
1154;b1701;0;10;10;62758.6456;protein;all
1532;b0886;0;1;1;62919.3832;protein;all
1881;b0077;0;1;1;62983.6301;protein;all
680;b1479;0;1;1;63196.5875;protein;all
777;b3835;0;1;1;63201.9661;protein;all
1447;b2487;0;1;1;63382.7562;protein;all
1514;b0680;0;1;1;63477.1448;protein;all
583;b2416;0;13;13;63561.0983;protein;all
1838;b1197;0;1;1;63635.9564;protein;all
1535;b0194;0;1;1;63691.8334;protein;all
622;b3519;0;1;1;63695.933;protein;all
1073;b3665;0;1;1;63738.6276;protein;all
1804;b3546;0;2;2;63803.636;protein;all
623;b4239;0;1;1;63836.9039;protein;all
1863;b0084;0;2;2;63876.6545;protein;all
871;b2763;0;1;1;63997.3637;protein;all
1172;b2723;0;1;1;64076.3978;protein;all
1264;b0723;0;1;1;64421.1307;protein;all
1505;b0914;0;32;32;64459.9792;protein;all
1257;b2133;0;2;2;64611.5553;protein;all
1333;b1851;0;1;1;64638.3097;protein;all
1500;b1876;0;1;1;64682.2167;protein;all
998;b0507;0;1;1;64731.0383;protein;all
591;b2802;0;1;1;64975.9801;protein;all
1170;b2721;0;1;1;64979.6287;protein;all
1533;b0887;0;1;1;65055.3721;protein;all
1691;b0657 * b1677;1;1;2;65388.4867;assembly;all
1865;b3771;0;2;2;65530.8741;protein;all
1508;b1866;0;1;1;65912.6907;protein;all
728;b4154;0;1;1;65970.8803;protein;all
985;b0115;0;1;1;66095.2674;protein;all
1162;b0973;0;1;1;66252.6147;protein;all
872;b2764;0;1;1;66268.9886;protein;all
1734;b3350;0;1;1;66410.3721;protein;all
1197;b2278;0;1;1;66437.2898;protein;all
732;b3729;0;1;1;66893.5317;protein;all
879;b0420;0;1;1;67616.1566;protein;all
156;cystrna * eftu * gtp;1;1;2;67648.1;assembly;all
1735;b0047;0;1;1;67795.0488;protein;all
184;eftu * glytrna * gtp;1;1;2;67804.1;assembly;all
1329;b1252 * b3005 * b3006;1;7;8;67907.8181;assembly;all
240;eftu * glntrna * gtp;1;1;2;67930;assembly;all
1769;b3599;0;1;1;67971.4753;protein;all
1205;b2286;0;1;1;68235.3024;protein;all
205;eftu * gtp * lystrna;1;1;2;68247.4;assembly;all
170;eftu * glutrna * gtp;1;1;2;68247.5;assembly;all
261;eftu * gtp * thrtrna;1;1;2;68292.5;assembly;all
226;asntrna * eftu * gtp;1;1;2;68302.4;assembly;all
275;eftu * gtp * trptrna;1;1;2;68331.5;assembly;all
1273;b0679;0;1;1;68346.0661;protein;all
268;eftu * gtp * valtrna;1;1;2;68352.5;assembly;all
177;eftu * gtp * phetrna;1;1;2;68354;assembly;all
108;alatrna * eftu * gtp;1;1;2;68393.5;assembly;all
1330;b3966;0;1;1;68406.2387;protein;all
212;eftu * emettrna * gtp;1;1;2;68597.6;assembly;all
247;argtrna * eftu * gtp;1;1;2;68658.7;assembly;all
163;asptrna * eftu * gtp;1;1;2;68684.6;assembly;all
233;eftu * gtp * protrna;1;1;2;68715.7;assembly;all
198;eftu * gtp * iletrna;1;1;2;68724.7;assembly;all
465;selB;0;1;1;68866.6;protein;all
616;b0403;0;5;5;69040.1726;protein;all
1684;b0829;0;1;1;69113.1954;protein;all
1254;b0888 * b0888;1;1;2;69245.273;assembly;all
1732;b3747;0;1;1;69293.2909;protein;all
473;gdp * selB;0;1;1;69309.6;assembly;all
553;b0335;0;1;1;69350.1066;protein;all
466;gtp * selB;2;0;2;69389.6;assembly;all
1751;b0731;0;1;1;69667.0732;protein;all
817;b3990 * b3991;1;1;2;70215.4107;assembly;all
1409;b0153;0;1;1;70422.2031;protein;all
710;b2988;0;2;2;70531.0949;protein;all
1681;b4213;0;8;8;70831.3216;protein;all
801;b3994;0;1;1;70849.5592;protein;all
1864;b0635;0;2;2;70855.7153;protein;all
739;b0728 * b0729;1;1;2;71169.2892;assembly;all
191;eftu * gtp * histrna;1;1;2;71180.2;assembly;all
282;eftu * gtp * tyrtrna;1;1;2;71180.2;assembly;all
1880;b3670 * b3671;1;1;2;71545.5494;assembly;all
1551;b1260 * b1261;1;1;2;71706.3447;assembly;all
852;b1812 * b3360;1;1;2;71740.5538;assembly;all
219;eftu * gtp * leutrna;1;1;2;71963.6;assembly;all
1397;b4069;0;1;1;72092.7077;protein;all
1722;b0697;0;1;1;72198.3227;protein;all
1335;b2935;0;2;2;72210.9049;protein;all
1873;b0071 * b0072;1;1;2;72368.4976;assembly;all
1442;b2482;0;1;1;72582.1781;protein;all
254;eftu * gtp * sertrna;1;1;2;72944.3;assembly;all
1336;b2465;0;2;2;73041.8293;protein;all
1850;b4392;0;4;4;73352.2971;protein;all
983;b3431;0;1;1;73575.7647;protein;all
1583;b3781 * b4136;1;1;2;73600.826;assembly;all
890;b2411;0;1;1;73605.1715;protein;all
1625;b2155;0;1;1;73894.7928;protein;all
1713;b2938;0;1;1;73897.6193;protein;all
1537;b1719;0;1;1;74013.4825;protein;all
472;efts * eftu * gdp;1;1;2;74148.6;assembly;all
1894;b2255;0;2;2;74287.9803;protein;all
1190;b0431;0;1;1;74367.0155;protein;all
1808;b2199 * b2200 * b2201;1;1;2;74556.4868;assembly;all
1629;b3571;0;1;1;75711.7413;protein;all
1485;b0314;0;1;1;75841.2563;protein;all
1526;b2114;0;1;1;76253.8413;protein;all
1515;b3559;0;1;1;76812.0045;protein;all
1476;b3469;0;6;6;76838.9583;protein;all
501;b2341;0;16;16;77071.2984;protein;all
648;b2297;0;2;2;77171.188;protein;all
1584;b2582 * b4136;1;1;2;77348.949;assembly;all
463;efg;0;1;1;77580.4;protein;all
658;b2917;0;1;1;77870.3498;protein;all
664;b2095 * b2096;1;1;2;77919.7524;assembly;all
82;efg * gdp;460;1;461;78023.4;assembly;all
80;efg * gtp;2;460;462;78103.4;assembly;all
1676;b0809 * b0810 * b0811;1;1;2;78284.4278;assembly;all
661;b3132 * b3137;1;1;2;78485.1813;assembly;all
628;b3416;0;4;4;78502.5889;protein;all
349;rlmL;1;1;2;78853.2;assembly;all
830;b3650;0;2;2;79341.536;protein;all
1452;b4079;0;2;2;79372.9541;protein;all
715;b2965;0;1;1;79415.2073;protein;all
500;b3846;0;19;19;79592.9534;protein;all
1107;b4238;0;4;4;80021.631;protein;all
1572;b3942;0;1;1;80022.7992;protein;all
1228;b2501;0;2;2;80430.4925;protein;all
1078;b2675;0;1;1;80478.0537;protein;all
673;b2976;0;1;1;80487.5899;protein;all
1494;b0186;0;1;1;80589.3758;protein;all
945;b2836;0;15;15;80699.0443;protein;all
1883;b0077 * b0078;1;1;2;80960.1717;assembly;all
1255;b0888 * b0888 * b3781;1;1;2;81051.7549;assembly;all
1121;b2440 * b2441;1;1;2;81183.7476;assembly;all
1799;b2027 * b2035;1;1;2;81198.0596;assembly;all
1506;b1102;0;1;1;81231.6635;protein;all
1495;b4131;0;1;1;81259.1991;protein;all
1146;b2866;0;1;1;81319.9047;protein;all
1623;b0805;0;1;1;81959.0396;protein;all
1630;b0584;0;1;1;82105.8793;protein;all
1627;b0150;0;1;1;82181.249;protein;all
716;b0693;0;1;1;82414.8381;protein;all
681;b2463;0;1;1;82416.4419;protein;all
1754;b2132;0;1;1;83459.0619;protein;all
411;relA;1;20;21;83874.6;assembly;all
414;ppGppp * relA;21;2;23;83874.6;assembly;all
829;b2784;0;2;2;83874.6244;protein;all
1571;b1732;0;1;1;84161.5419;protein;all
997;b3432;0;1;1;84335.8412;protein;all
1743;b1386;0;3;3;84377.6245;protein;all
705;b4117;0;1;1;84424.2842;protein;all
1609;b3409;0;1;1;84472.7003;protein;all
1011;b3829;0;1;1;84672.4709;protein;all
1031;b2519;0;2;2;85065.8962;protein;all
1616;b4291;0;1;1;85320.5409;protein;all
514;b0903;0;1;1;85356.2412;protein;all
1085;b2234;0;1;1;85774.2591;protein;all
847;b3551;0;2;2;85849.6589;protein;all
518;b3114;0;1;1;85934.5257;protein;all
1437;b3951;0;1;1;85958.7332;protein;all
1315;b0124;0;1;1;86746.3046;protein;all
1528;b1713;0;1;1;87377.0775;protein;all
1869;b2893 * b4136;1;1;2;87415.7337;assembly;all
981;b1702;0;1;1;87434.0998;protein;all
908;b2751 * b2752;1;1;2;87745.7207;assembly;all
1527;b0484;0;1;1;87872.1304;protein;all
1488;b3940;0;2;2;88886.5957;protein;all
1275;b1872;0;1;1;88962.9402;protein;all
1487;b0002;0;2;2;89119.2202;protein;all
585;b0221;0;8;8;89223.3748;protein;all
1870;b0604 * b4136;1;1;2;89289.0167;assembly;all
1152;b1094 * b2836;1;1;2;89338.4608;assembly;all
1915;b1857 * b1858 * b1859;1;1;2;89372.4399;assembly;all
1247;b1587;0;1;1;89778.9705;protein;all
1248;b1588;0;1;1;89986.0387;protein;all
1118;b1489;0;1;1;90259.3349;protein;all
1223;b0894;0;1;1;90397.6071;protein;all
1765;b0197 * b0198 * b0199;1;1;2;90474.9825;assembly;all
629;b3417;0;5;5;90521.2686;protein;all
1596;b3785 * b3793;1;1;2;91005.2739;assembly;all
1468;b0933 * b0934 * b0936;1;1;2;91220.1461;assembly;all
954;b4041;0;7;7;91380.3649;protein;all
1324;b0158 * b1709 * b1711;1;1;2;91396.2282;assembly;all
1776;b0763 * b0764 * b0765;1;1;2;91404.317;assembly;all
1472;b0365 * b0366 * b0367;1;1;2;92373.5946;assembly;all
1066;b2206;0;1;1;93040.9282;protein;all
1212;b3365;0;1;1;93120.2686;protein;all
982;b3428;0;2;2;93171.4122;protein;all
511;b0118;0;3;3;93497.015;protein;all
1033;b3396;0;5;5;93635.031;protein;all
1032;b0149;0;5;5;94291.4317;protein;all
1279;b0997;0;1;1;94454.8035;protein;all
1063;b2710 * b2711;1;1;2;95636.6875;assembly;all
1499;b2697;0;1;1;96031.257;protein;all
1399;b1241;0;2;2;96126.0894;protein;all
1520;b0642;0;1;1;97232.6634;protein;all
1117;b3806;0;1;1;97584.8332;protein;all
731;b1276;0;2;2;97676.0683;protein;all
1911;b3577 * b3578 * b3579;1;1;2;98852.9335;assembly;all
721;b0932;0;2;2;98917.745;protein;all
743;b0615 * b0616 * b0617;1;1;2;98970.5015;assembly;all
675;b3956;0;1;1;99061.4335;protein;all
1766;b4242;0;2;2;99465.3217;protein;all
984;b0114;0;1;1;99667.2782;protein;all
1109;b2895 * b4238;1;0;1;99721.5824;assembly;all
1111;b0684 * b4238;1;1;2;99758.3301;assembly;all
1661;b2092 * b2093 * b2094 * b2415 * b2416;1;1;2;99827.5655;assembly;all
617;b0732;0;1;1;100013.829;protein;all
1202;b2283;0;1;1;100298.0542;protein;all
1157;b0978 * b0979;1;1;2;100342.5079;assembly;all
1160;b0733 * b0734;1;1;2;100657.0103;assembly;all
1167;b2994 * b2997;1;1;2;102141.9879;assembly;all
1187;b1602 * b1603;1;1;2;103345.2608;assembly;all
1519;b0026;0;1;1;104295.6111;protein;all
928;b2903;0;1;1;104375.1855;protein;all
734;b0726;0;1;1;105060.4808;protein;all
1214;b3365 * b3366;1;1;2;105404.1302;assembly;all
1415;b2306 * b2307 * b2308 * b2310;1;1;2;108162.4272;assembly;all
1540;b4258;0;1;1;108191.0891;protein;all
1709;b2306 * b2307 * b2308 * b2309;1;1;2;108654.1401;assembly;all
1067;b2203 * b2206;1;2;3;109337.2896;assembly;all
469;if2;0;1;1;110520;protein;all
298;gdp * if2;1;1;2;110963;assembly;all
289;gtp * if2;2;3;5;111043;assembly;all
1717;b3266;0;1;1;111453.0688;protein;all
1517;b3559 * b3560;1;1;2;111585.9795;assembly;all
1436;b0652 * b0653 * b0654 * b0655;1;1;2;112497.3594;assembly;all
1312;b3894;0;1;1;112548.0893;protein;all
1306;b1474;0;1;1;112962.0291;protein;all
515;b0902 * b0903;1;1;2;113560.2305;assembly;all
519;b0902 * b3114;1;1;2;114138.515;assembly;all
1560;b1263 * b1264;1;1;2;114363.0886;assembly;all
1349;b0575;0;1;1;114705.7487;protein;all
615;b0344;0;1;1;116481.4806;protein;all
1080;b2675 * b2676;1;4;5;116920.8464;assembly;all
1512;b2677 * b2678 * b2679;1;1;2;117803.6227;assembly;all
683;b0033;0;1;1;117840.3704;protein;all
1266;b0721 * b0722 * b0723 * b0724;1;1;2;118357.09;assembly;all
1439;b3951 * b3952;1;1;2;118388.0451;assembly;all
745;b0614 * b0615 * b0616 * b0617;1;1;2;119240.6269;assembly;all
1877;b0066 * b0067 * b0068;1;1;2;120694.2819;assembly;all
729;b4151 * b4152 * b4153 * b4154;1;1;2;121215.3015;assembly;all
1385;b4086 * b4087 * b4088;1;1;2;123969.0109;assembly;all
1530;b1713 * b1714;1;1;2;124208.4409;assembly;all
1404;b1900 * b1901 * b4460;1;1;2;124768.5989;assembly;all
1084;b2675 * b2676 * b3610;1;1;2;126058.245;assembly;all
1082;b0849 * b2675 * b2676;1;1;2;126605.5836;assembly;all
576;b2538 * b2539 * b2540 * b2542;1;1;2;126993.9389;assembly;all
1651;b2148 * b2149 * b2150;1;1;2;127676.4675;assembly;all
517;b0902 * b0903 * b2579;1;1;2;127844.2386;assembly;all
1534;b0886 * b0887;1;1;2;127974.7553;assembly;all
1277;b1872 * b1873;1;1;2;129248.9309;assembly;all
1087;b2234 * b2235;1;2;3;129291.01;assembly;all
1149;b2866 * b2867 * b2868;1;1;2;129797.9117;assembly;all
1081;b1654 * b2675 * b2676;1;1;2;129799.4631;assembly;all
873;b2763 * b2764;1;1;2;130266.3523;assembly;all
1615;b4287 * b4288 * b4289 * b4290;1;1;2;130359.701;assembly;all
1421;b0860 * b0861 * b0862 * b0863 * b0864;1;1;2;131910.38;assembly;all
1410;b0151 * b0152 * b0153;1;1;2;132306.2534;assembly;all
1069;b2202 * b2203 * b2206;1;1;2;132437.6037;assembly;all
1816;b3725 * b3726 * b3727 * b3728;1;1;2;132492.3938;assembly;all
1622;b0588 * b0589 * b0590 * b0592;1;1;2;132847.0938;assembly;all
1906;b3566 * b3567 * b3568;1;1;2;133233.7261;assembly;all
1484;b2128 * b2129 * b2130 * b2131;1;1;2;133685.2366;assembly;all
1057;b4070 * b4071 * b4072 * b4073;1;1;2;134025.6336;assembly;all
1164;b0972 * b0973 * b0974;1;1;2;134530.5473;assembly;all
1233;b0185 * b2316 * b3255 * b3256;1;1;2;134569.9215;assembly;all
1849;b3748 * b3749 * b3750 * b3751;1;1;2;134734.8276;assembly;all
300;gtp * if2 * imettrna;1;2;3;135908.7;assembly;all
1010;b4019;0;1;1;135995.4316;protein;all
1331;b1252 * b3005 * b3006 * b3966;1;1;2;136314.0568;assembly;all
506;b2979 * b4467 * b4468;1;1;2;137281.279;assembly;all
1280;b0996 * b0997;1;1;2;138060.8749;assembly;all
1859;b2415 * b2416 * b2702 * b2703 * b2704;1;1;2;139895.9652;assembly;all
1178;b1468;0;1;1;140225.0188;protein;all
1180;b1224;0;1;1;140487.7403;protein;all
1781;b2422 * b2423 * b2424 * b3917;1;1;2;140545.8801;assembly;all
1770;b2415 * b2416 * b3599;1;1;2;140651.833;assembly;all
1287;b2415 * b2416 * b2417 * b2429;1;1;2;140732.5389;assembly;all
1730;b1291 * b3290 * b3849;1;1;2;140986.5361;assembly;all
1274;b0679 * b2415 * b2416;1;1;2;141026.4238;assembly;all
1088;b2234 * b2235 * b3781;1;1;2;141097.4919;assembly;all
1083;b1064 * b2675 * b2676;1;1;2;141270.7667;assembly;all
1379;b2557;0;1;1;141401.0628;protein;all
1783;b2422 * b2423 * b2424 * b2425;1;1;2;141501.138;assembly;all
1272;b1101 * b2415 * b2416 * b2417;1;1;2;141607.1182;assembly;all
1626;b1252 * b3005 * b3006 * b2155;1;1;2;141802.6109;assembly;all
1728;b1291 * b1363 * b3290;1;1;2;141970.578;assembly;all
836;b0586;0;1;1;141989.2243;protein;all
1888;b2415 * b2416 * b2417 * b4240;1;1;2;142011.3385;assembly;all
1829;b1123 * b1124 * b1125 * b1126;1;1;2;142066.534;assembly;all
1752;b0731 * b2415 * b2416;1;1;2;142347.4309;assembly;all
1834;b1440 * b1441 * b1442 * b1443;1;1;2;142416.0266;assembly;all
687;b1014;0;2;2;143813.4336;protein;all
1192;b0429 * b0430 * b0431 * b0432;1;1;2;143929.6205;assembly;all
1226;b0894 * b0895 * b0896;1;1;2;144092.2266;assembly;all
1089;b2234 * b2235 * b2582;1;1;2;144845.6149;assembly;all
1108;b2895 * b3924 * b4237 * b4238;1;1;2;144917.9162;assembly;all
1112;b0684 * b3924 * b4237 * b4238;1;0;1;144954.6639;assembly;all
1669;b1621 * b2415 * b2416 * b2417;1;1;2;147557.522;assembly;all
1220;b2241 * b2242 * b2243;1;1;2;148421.8662;assembly;all
1824;b0854 * b0855 * b0856 * b0857;1;1;2;148798.7143;assembly;all
1507;b1102 * b1252 * b3005 * b3006;1;1;2;149139.4816;assembly;all
1624;b0805 * b1252 * b3005 * b3006;1;1;2;149866.8577;assembly;all
1631;b0584 * b1252 * b3005 * b3006;1;1;2;150013.6974;assembly;all
1628;b0150 * b1252 * b3005 * b3006;1;1;2;150089.0671;assembly;all
1429;b2415 * b2416 * b4193 * b4194 * b4195;1;1;2;151550.1398;assembly;all
1724;b0696 * b0697 * b0698;1;1;2;151653.6336;assembly;all
1647;b3450 * b3451 * b3452 * b3453;1;1;2;152734.1834;assembly;all
1718;b3265 * b3266;1;1;2;152770.2272;assembly;all
1617;b1252 * b3005 * b3006 * b4291;1;1;2;153228.359;assembly;all
684;b0032 * b0033;1;1;2;159270.8807;assembly;all
1844;b4227 * b4230 * b4231 * b4485;1;1;2;160239.3826;assembly;all
933;b3212;0;1;1;163295.057;protein;all
1285;b1817 * b1818 * b1819 * b2415 * b2416;1;1;2;166318.08;assembly;all
1639;b2167 * b2169 * b2415 * b2416;1;1;2;169846.1792;assembly;all
1313;b3892 * b3893 * b3894;1;1;2;170254.1962;assembly;all
1309;b1474 * b1475 * b1476;1;1;2;170568.6332;assembly;all
1299;b3731 * b3732 * b3733 * b3734 * b3735;1;2;3;171523.4148;assembly;all
1360;b3454 * b3455 * b3456 * b3457 * b3460;1;1;2;173063.038;assembly;all
1741;b3454 * b3455 * b3456 * b3457 * b3458;1;1;2;173365.3366;assembly;all
1242;b4032 * b4033 * b4034 * b4035;1;1;2;173614.7583;assembly;all
1792;b3476 * b3477 * b3478 * b3479 * b3480;1;1;2;180868.9949;assembly;all
584;b1198 * b1199 * b1200 * b2415 * b2416;1;1;2;184974.6552;assembly;all
1072;b2202 * b2203 * b2206 * b2204 * b2205;1;1;2;189235.2642;assembly;all
1688;b0829 * b0830 * b0831 * b0832;1;1;2;192886.5725;assembly;all
1372;b1483 * b1484 * b1485 * b1486 * b1487;1;1;2;197675.584;assembly;all
736;b0116 * b0726 * b0727;1;1;2;199759.2349;assembly;all
1049;b1244 * b1245 * b1246 * b1247 * b1329;1;1;2;200748.9629;assembly;all
1052;b1243 * b1244 * b1245 * b1246 * b1247;1;1;2;201747.6863;assembly;all
1366;b3540 * b3541 * b3542 * b3543 * b3544;1;1;2;203501.5647;assembly;all
822;b0423 * b2530 * b3990 * b3991 * b3992 * b4407;1;1;2;204557.5309;assembly;all
931;b0116 * b2903 * b2904 * b2905;1;1;2;209020.3384;assembly;all
935;b3212 * b3213;1;1;2;215309.7674;assembly;all
986;b0114 * b0115 * b0116;1;1;2;216450.4248;assembly;all
1350;b0572 * b0573 * b0574 * b0575;1;1;2;221530.0939;assembly;all
1300;b3731 * b3732 * b3733 * b3734 * b3735 * b3736 * b3737 * b3738;1;1;2;227346.0719;assembly;all
1174;b2719 * b2720 * b2721 * b2722 * b2723 * b2724;1;2;3;232266.0528;assembly;all
1251;b1587 * b1588 * b1589 * b1590;1;1;2;233039.8759;assembly;all
1302;b3731 * b3732 * b3733 * b3734 * b3735 * b3736 * b3737 * b3738 * b3739;1;1;2;240977.6203;assembly;all
1184;b1224 * b1225 * b1226 * b1227;1;1;2;250499.1337;assembly;all
1179;b1465 * b1466 * b1467 * b1468;1;1;2;250960.1989;assembly;all
1454;b2719 * b2720 * b2721 * b2722 * b2723 * b2724 * b4079;1;0;1;311639.0069;assembly;all
86;mRNA;60;0;60;330000;placeholder;all
1451;b2481 * b2482 * b2483 * b2484 * b2485 * b2486 * b2487 * b2488 * b2489 * b2490;1;1;2;388196.6067;assembly;all
1453;b2481 * b2482 * b2483 * b2484 * b2485 * b2486 * b2487 * b2488 * b2489 * b2490 * b4079;1;1;2;467569.5608;assembly;all
341;rRNA16S;1;1;2;479462.3;RNA;all
340;prerRNA16S;0;1;1;508860;assembly;all
1208;b2276 * b2277 * b2278 * b2279 * b2280 * b2281 * b2282 * b2283 * b2284 * b2285 * b2286 * b2287 * b2288;1;1;2;540407.9749;assembly;all
84;30S;61;4;65;791940;assembly;all
391;tier1-30S;1;1;2;791940;assembly;all
394;tier2-30S;1;1;2;791940;assembly;all
404;tier3-30S;1;1;2;791940;assembly;all
303;30S * if3;1;1;2;812503.7;assembly;all
299;30S * if1 * if3;1;1;2;820753.2;assembly;all
353;rRNA23S;1;1;2;903535.6;RNA;all
290;30S * gtp * if2 * if3;1;1;2;923546.7;assembly;all
292;30S * gtp * if1 * if2 * if3;2;1;3;931796.2;assembly;all
352;prerRNA23S;0;1;1;958320;assembly;all
294;30Spic;3;1;4;962293;assembly;all
454;inactiveAsite;1;1;2;1089040;placeholder;all
85;50S;62;2;64;1468560;assembly;all
370;tier1-50S;1;1;2;1468560;assembly;all
374;tier2-50S;1;1;2;1468560;assembly;all
381;tier3-50S;1;1;2;1468560;assembly;all
383;tier4-50S;1;1;2;1468560;assembly;all
296;30Sini;1;1;2;1798560;assembly;all
301;70S;2;3;5;3267120;assembly;all
476;E-site;22;560;582;3267120;placeholder;all
477;A-site;423;45;468;3267120;placeholder;all
1;Asite * mRNAcodonUAG;2;21;23;3268110;assembly;all
70;Asite * mRNAcodonUAA;4;22;26;3268110;assembly;all
74;Asite * mRNAcodonUGA;2;21;23;3268110;assembly;all
110;Asite * mRNAcodonala;1;1;2;3268110;assembly;all
158;Asite * mRNAcodoncys;1;1;2;3268110;assembly;all
165;Asite * mRNAcodonasp;1;1;2;3268110;assembly;all
172;Asite * mRNAcodonglu;1;1;2;3268110;assembly;all
179;Asite * mRNAcodonphe;1;1;2;3268110;assembly;all
186;Asite * mRNAcodongly;1;1;2;3268110;assembly;all
193;Asite * mRNAcodonhis;1;1;2;3268110;assembly;all
200;Asite * mRNAcodonile;1;1;2;3268110;assembly;all
207;Asite * mRNAcodonlys;1;1;2;3268110;assembly;all
214;Asite * mRNAcodonmet;1;1;2;3268110;assembly;all
221;Asite * mRNAcodonleu;1;1;2;3268110;assembly;all
228;Asite * mRNAcodonasn;1;1;2;3268110;assembly;all
235;Asite * mRNAcodonpro;1;1;2;3268110;assembly;all
242;Asite * mRNAcodongln;1;1;2;3268110;assembly;all
249;Asite * mRNAcodonarg;1;1;2;3268110;assembly;all
256;Asite * mRNAcodonser;1;1;2;3268110;assembly;all
263;Asite * mRNAcodonthr;1;1;2;3268110;assembly;all
270;Asite * mRNAcodonval;1;1;2;3268110;assembly;all
277;Asite * mRNAcodontrp;1;1;2;3268110;assembly;all
284;Asite * mRNAcodontyr;1;1;2;3268110;assembly;all
456;70S * rmf;1;1;2;3273627.4;assembly;all
461;70S * pY;1;1;2;3279904.4;assembly;all
416;Asite * trnacys;2;2;4;3290962.1;assembly;all
424;Asite * trnagly;2;2;4;3291118.1;assembly;all
440;Asite * trnagln;2;2;4;3291244;assembly;all
430;Asite * trnalys;2;2;4;3291561.4;assembly;all
420;Asite * trnaglu;2;2;4;3291561.5;assembly;all
446;Asite * trnathr;2;2;4;3291606.5;assembly;all
436;Asite * trnaasn;2;2;4;3291616.4;assembly;all
450;Asite * trnatrp;2;2;4;3291645.5;assembly;all
448;Asite * trnaval;2;2;4;3291666.5;assembly;all
422;Asite * trnaphe;2;2;4;3291668;assembly;all
410;Asite * trnaala;2;2;4;3291707.5;assembly;all
8;Psite * mRNAcodoncys * trnacys;28;28;56;3291952.1;assembly;all
118;Esite * mRNAcodoncys * trnacys;20;1;21;3291952.1;assembly;all
442;Asite * trnaarg;2;2;4;3291972.7;assembly;all
432;Asite * trnamet;2;2;4;3291985.7;assembly;all
418;Asite * trnaasp;2;2;4;3291998.6;assembly;all
438;Asite * trnapro;2;2;4;3292029.7;assembly;all
428;Asite * trnaile;2;2;4;3292038.7;assembly;all
16;Psite * mRNAcodongly * trnagly;28;28;56;3292108.1;assembly;all
126;Esite * mRNAcodongly * trnagly;20;1;21;3292108.1;assembly;all
32;Psite * mRNAcodongln * trnagln;28;28;56;3292234;assembly;all
142;Esite * mRNAcodongln * trnagln;20;1;21;3292234;assembly;all
22;Psite * mRNAcodonlys * trnalys;28;28;56;3292551.4;assembly;all
132;Esite * mRNAcodonlys * trnalys;20;1;21;3292551.4;assembly;all
12;Psite * mRNAcodonglu * trnaglu;28;28;56;3292551.5;assembly;all
122;Esite * mRNAcodonglu * trnaglu;20;1;21;3292551.5;assembly;all
38;Psite * mRNAcodonthr * trnathr;28;28;56;3292596.5;assembly;all
148;Esite * mRNAcodonthr * trnathr;20;1;21;3292596.5;assembly;all
28;Psite * mRNAcodonasn * trnaasn;28;28;56;3292606.4;assembly;all
138;Esite * mRNAcodonasn * trnaasn;20;1;21;3292606.4;assembly;all
42;Psite * mRNAcodontrp * trnatrp;28;28;56;3292635.5;assembly;all
152;Esite * mRNAcodontrp * trnatrp;20;1;21;3292635.5;assembly;all
40;Psite * mRNAcodonval * trnaval;28;28;56;3292656.5;assembly;all
150;Esite * mRNAcodonval * trnaval;20;1;21;3292656.5;assembly;all
14;Psite * mRNAcodonphe * trnaphe;28;28;56;3292658;assembly;all
124;Esite * mRNAcodonphe * trnaphe;20;1;21;3292658;assembly;all
5;Psite * mRNAcodonala * trnaala;28;28;56;3292697.5;assembly;all
116;Esite * mRNAcodonala * trnaala;20;1;21;3292697.5;assembly;all
34;Psite * mRNAcodonarg * trnaarg;28;28;56;3292962.7;assembly;all
144;Esite * mRNAcodonarg * trnaarg;20;1;21;3292962.7;assembly;all
24;Psite * mRNAcodonmet * trnamet;28;28;56;3292975.7;assembly;all
134;Esite * mRNAcodonmet * trnamet;20;1;21;3292975.7;assembly;all
10;Psite * mRNAcodonasp * trnaasp;28;28;56;3292988.6;assembly;all
120;Esite * mRNAcodonasp * trnaasp;20;1;21;3292988.6;assembly;all
30;Psite * mRNAcodonpro * trnapro;28;28;56;3293019.7;assembly;all
140;Esite * mRNAcodonpro * trnapro;20;1;21;3293019.7;assembly;all
20;Psite * mRNAcodonile * trnaile;28;28;56;3293028.7;assembly;all
130;Esite * mRNAcodonile * trnaile;20;1;21;3293028.7;assembly;all
434;Asite * trnaleu;2;2;4;3293502.8;assembly;all
26;Psite * mRNAcodonleu * trnaleu;28;28;56;3294492.8;assembly;all
136;Esite * mRNAcodonleu * trnaleu;20;1;21;3294492.8;assembly;all
426;Asite * trnahis;2;2;4;3294494.2;assembly;all
452;Asite * trnatyr;2;2;4;3294494.2;assembly;all
18;Psite * mRNAcodonhis * trnahis;28;28;56;3295484.2;assembly;all
44;Psite * mRNAcodontyr * trnatyr;28;28;56;3295484.2;assembly;all
128;Esite * mRNAcodonhis * trnahis;20;1;21;3295484.2;assembly;all
154;Esite * mRNAcodontyr * trnatyr;20;1;21;3295484.2;assembly;all
444;Asite * trnaser;2;2;4;3296258.3;assembly;all
36;Psite * mRNAcodonser * trnaser;28;28;56;3297248.3;assembly;all
146;Esite * mRNAcodonser * trnaser;20;1;21;3297248.3;assembly;all
3;Asite * mRNAcodonUAG * rf1;41;61;102;3308626.8;assembly;all
71;Asite * mRNAcodonUAA * rf1;41;61;102;3308626.8;assembly;all
76;Asite * mRNAcodonUGA * rf2;41;61;102;3309360.2;assembly;all
78;Asite * mRNAcodonUAA * rf2;41;61;102;3309360.2;assembly;all
7;Psite * mRNAcodoncys * peptide * trnacys;0;8;8;3335152.1;assembly;all
117;Psite * mRNAcodoncys * peptide - trnacys;20;20;40;3335152.1;assembly;all
161;Asite * mRNAcodoncys * peptide - trnacys;20;20;40;3335152.1;assembly;all
15;Psite * mRNAcodongly * peptide * trnagly;0;8;8;3335308.1;assembly;all
125;Psite * mRNAcodongly * peptide - trnagly;20;20;40;3335308.1;assembly;all
189;Asite * mRNAcodongly * peptide - trnagly;20;20;40;3335308.1;assembly;all
31;Psite * mRNAcodongln * peptide * trnagln;0;8;8;3335434;assembly;all
141;Psite * mRNAcodongln * peptide - trnagln;20;20;40;3335434;assembly;all
245;Asite * mRNAcodongln * peptide - trnagln;20;20;40;3335434;assembly;all
160;Asite * cystrna * eftu * gdp * mRNAcodoncys;1;20;21;3335678.1;assembly;all
21;Psite * mRNAcodonlys * peptide * trnalys;0;8;8;3335751.4;assembly;all
131;Psite * mRNAcodonlys * peptide - trnalys;20;20;40;3335751.4;assembly;all
210;Asite * mRNAcodonlys * peptide - trnalys;20;20;40;3335751.4;assembly;all
11;Psite * mRNAcodonglu * peptide * trnaglu;0;8;8;3335751.5;assembly;all
121;Psite * mRNAcodonglu * peptide - trnaglu;20;20;40;3335751.5;assembly;all
175;Asite * mRNAcodonglu * peptide - trnaglu;20;20;40;3335751.5;assembly;all
159;Asite * cystrna * eftu * gtp * mRNAcodoncys;1;1;2;3335758.1;assembly;all
37;Psite * mRNAcodonthr * peptide * trnathr;0;8;8;3335796.5;assembly;all
147;Psite * mRNAcodonthr * peptide - trnathr;20;20;40;3335796.5;assembly;all
266;Asite * mRNAcodonthr * peptide - trnathr;20;20;40;3335796.5;assembly;all
27;Psite * mRNAcodonasn * peptide * trnaasn;0;8;8;3335806.4;assembly;all
137;Psite * mRNAcodonasn * peptide - trnaasn;20;20;40;3335806.4;assembly;all
231;Asite * mRNAcodonasn * peptide - trnaasn;20;20;40;3335806.4;assembly;all
188;Asite * eftu * gdp * glytrna * mRNAcodongly;1;20;21;3335834.1;assembly;all
41;Psite * mRNAcodontrp * peptide * trnatrp;0;8;8;3335835.5;assembly;all
151;Psite * mRNAcodontrp * peptide - trnatrp;20;20;40;3335835.5;assembly;all
280;Asite * mRNAcodontrp * peptide - trnatrp;20;20;40;3335835.5;assembly;all
39;Psite * mRNAcodonval * peptide * trnaval;0;8;8;3335856.5;assembly;all
149;Psite * mRNAcodonval * peptide - trnaval;20;20;40;3335856.5;assembly;all
273;Asite * mRNAcodonval * peptide - trnaval;20;20;40;3335856.5;assembly;all
13;Psite * mRNAcodonphe * peptide * trnaphe;0;8;8;3335858;assembly;all
123;Psite * mRNAcodonphe * peptide - trnaphe;20;20;40;3335858;assembly;all
182;Asite * mRNAcodonphe * peptide - trnaphe;20;20;40;3335858;assembly;all
4;Psite * mRNAcodonala * peptide * trnaala;0;8;8;3335897.5;assembly;all
113;Psite * mRNAcodonala * peptide - trnaala;20;20;40;3335897.5;assembly;all
114;Asite * mRNAcodonala * peptide - trnaala;20;20;40;3335897.5;assembly;all
187;Asite * eftu * glytrna * gtp * mRNAcodongly;1;1;2;3335914.1;assembly;all
244;Asite * eftu * gdp * glntrna * mRNAcodongln;1;20;21;3335960;assembly;all
243;Asite * eftu * glntrna * gtp * mRNAcodongln;1;1;2;3336040;assembly;all
33;Psite * mRNAcodonarg * peptide * trnaarg;0;8;8;3336162.7;assembly;all
143;Psite * mRNAcodonarg * peptide - trnaarg;20;20;40;3336162.7;assembly;all
252;Asite * mRNAcodonarg * peptide - trnaarg;20;20;40;3336162.7;assembly;all
23;Psite * mRNAcodonmet * peptide * trnamet;0;8;8;3336175.7;assembly;all
133;Psite * mRNAcodonmet * peptide - trnamet;20;20;40;3336175.7;assembly;all
217;Asite * mRNAcodonmet * peptide - trnamet;20;20;40;3336175.7;assembly;all
297;Psite * mRNACodonMet * peptide * trnamet;2;0;2;3336175.7;assembly;all
9;Psite * mRNAcodonasp * peptide * trnaasp;0;8;8;3336188.6;assembly;all
119;Psite * mRNAcodonasp * peptide - trnaasp;20;20;40;3336188.6;assembly;all
168;Asite * mRNAcodonasp * peptide - trnaasp;20;20;40;3336188.6;assembly;all
29;Psite * mRNAcodonpro * peptide * trnapro;0;8;8;3336219.7;assembly;all
139;Psite * mRNAcodonpro * peptide - trnapro;20;20;40;3336219.7;assembly;all
238;Asite * mRNAcodonpro * peptide - trnapro;20;20;40;3336219.7;assembly;all
19;Psite * mRNAcodonile * peptide * trnaile;0;8;8;3336228.7;assembly;all
129;Psite * mRNAcodonile * peptide - trnaile;20;20;40;3336228.7;assembly;all
203;Asite * mRNAcodonile * peptide - trnaile;20;20;40;3336228.7;assembly;all
209;Asite * eftu * gdp * lystrna * mRNAcodonlys;1;20;21;3336277.4;assembly;all
174;Asite * eftu * gdp * glutrna * mRNAcodonglu;1;20;21;3336277.5;assembly;all
265;Asite * eftu * gdp * mRNAcodonthr * thrtrna;1;20;21;3336322.5;assembly;all
230;Asite * asntrna * eftu * gdp * mRNAcodonasn;1;20;21;3336332.4;assembly;all
208;Asite * eftu * gtp * lystrna * mRNAcodonlys;1;1;2;3336357.4;assembly;all
173;Asite * eftu * glutrna * gtp * mRNAcodonglu;1;1;2;3336357.5;assembly;all
279;Asite * eftu * gdp * mRNAcodontrp * trptrna;1;20;21;3336361.5;assembly;all
272;Asite * eftu * gdp * mRNAcodonval * valtrna;1;20;21;3336382.5;assembly;all
181;Asite * eftu * gdp * mRNAcodonphe * phetrna;1;20;21;3336384;assembly;all
264;Asite * eftu * gtp * mRNAcodonthr * thrtrna;1;1;2;3336402.5;assembly;all
229;Asite * asntrna * eftu * gtp * mRNAcodonasn;1;1;2;3336412.4;assembly;all
112;Asite * alatrna * eftu * gdp * mRNAcodonala;1;20;21;3336423.5;assembly;all
278;Asite * eftu * gtp * mRNAcodontrp * trptrna;1;1;2;3336441.5;assembly;all
271;Asite * eftu * gtp * mRNAcodonval * valtrna;1;1;2;3336462.5;assembly;all
180;Asite * eftu * gtp * mRNAcodonphe * phetrna;1;1;2;3336464;assembly;all
111;Asite * alatrna * eftu * gtp * mRNAcodonala;1;1;2;3336503.5;assembly;all
216;Asite * eftu * emettrna * gdp * mRNAcodonmet;1;20;21;3336627.6;assembly;all
251;Asite * argtrna * eftu * gdp * mRNAcodonarg;1;20;21;3336688.7;assembly;all
215;Asite * eftu * emettrna * gtp * mRNAcodonmet;1;1;2;3336707.6;assembly;all
167;Asite * asptrna * eftu * gdp * mRNAcodonasp;1;20;21;3336714.6;assembly;all
237;Asite * eftu * gdp * mRNAcodonpro * protrna;1;20;21;3336745.7;assembly;all
202;Asite * eftu * gdp * iletrna * mRNAcodonile;1;20;21;3336754.7;assembly;all
250;Asite * argtrna * eftu * gtp * mRNAcodonarg;1;1;2;3336768.7;assembly;all
166;Asite * asptrna * eftu * gtp * mRNAcodonasp;1;1;2;3336794.6;assembly;all
236;Asite * eftu * gtp * mRNAcodonpro * protrna;1;1;2;3336825.7;assembly;all
201;Asite * eftu * gtp * iletrna * mRNAcodonile;1;1;2;3336834.7;assembly;all
25;Psite * mRNAcodonleu * peptide * trnaleu;0;8;8;3337692.8;assembly;all
135;Psite * mRNAcodonleu * peptide - trnaleu;20;20;40;3337692.8;assembly;all
224;Asite * mRNAcodonleu * peptide - trnaleu;20;20;40;3337692.8;assembly;all
17;Psite * mRNAcodonhis * peptide * trnahis;0;8;8;3338684.2;assembly;all
43;Psite * mRNAcodontyr * peptide * trnatyr;0;8;8;3338684.2;assembly;all
127;Psite * mRNAcodonhis * peptide - trnahis;20;20;40;3338684.2;assembly;all
153;Psite * mRNAcodontyr * peptide - trnatyr;20;20;40;3338684.2;assembly;all
196;Asite * mRNAcodonhis * peptide - trnahis;20;20;40;3338684.2;assembly;all
287;Asite * mRNAcodontyr * peptide - trnatyr;20;20;40;3338684.2;assembly;all
195;Asite * eftu * gdp * histrna * mRNAcodonhis;1;20;21;3339210.2;assembly;all
286;Asite * eftu * gdp * mRNAcodontyr * tyrtrna;1;20;21;3339210.2;assembly;all
194;Asite * eftu * gtp * histrna * mRNAcodonhis;1;1;2;3339290.2;assembly;all
285;Asite * eftu * gtp * mRNAcodontyr * tyrtrna;1;1;2;3339290.2;assembly;all
223;Asite * eftu * gdp * leutrna * mRNAcodonleu;1;20;21;3339993.6;assembly;all
222;Asite * eftu * gtp * leutrna * mRNAcodonleu;1;1;2;3340073.6;assembly;all
35;Psite * mRNAcodonser * peptide * trnaser;0;8;8;3340448.3;assembly;all
145;Psite * mRNAcodonser * peptide - trnaser;20;20;40;3340448.3;assembly;all
259;Asite * mRNAcodonser * peptide - trnaser;20;20;40;3340448.3;assembly;all
258;Asite * eftu * gdp * mRNAcodonser * sertrna;1;20;21;3340974.3;assembly;all
257;Asite * eftu * gtp * mRNAcodonser * sertrna;1;1;2;3341054.3;assembly;all
46;Asite * gtp * mRNAcodonUAG * rf1 * rf3;41;21;62;3368723.2;assembly;all
72;Asite * gtp * mRNAcodonUAA * rf1 * rf3;41;21;62;3368723.2;assembly;all
77;Asite * gtp * mRNAcodonUGA * rf2 * rf3;41;21;62;3369456.6;assembly;all
79;Asite * gtp * mRNAcodonUAA * rf2 * rf3;41;21;62;3369456.6;assembly;all
417;Asite * relA * trnacys;1;1;2;3374836.7;assembly;all
425;Asite * relA * trnagly;1;1;2;3374992.7;assembly;all
441;Asite * relA * trnagln;1;1;2;3375118.6;assembly;all
431;Asite * relA * trnalys;1;1;2;3375436;assembly;all
421;Asite * relA * trnaglu;1;1;2;3375436.1;assembly;all
447;Asite * relA * trnathr;1;1;2;3375481.1;assembly;all
437;Asite * relA * trnaasn;1;1;2;3375491;assembly;all
451;Asite * relA * trnatrp;1;1;2;3375520.1;assembly;all
449;Asite * relA * trnaval;1;1;2;3375541.1;assembly;all
423;Asite * relA * trnaphe;1;1;2;3375542.6;assembly;all
412;Asite * relA * trnaala;1;1;2;3375582.1;assembly;all
443;Asite * relA * trnaarg;1;1;2;3375847.3;assembly;all
433;Asite * relA * trnamet;1;1;2;3375860.3;assembly;all
419;Asite * relA * trnaasp;1;1;2;3375873.2;assembly;all
439;Asite * relA * trnapro;1;1;2;3375904.3;assembly;all
429;Asite * relA * trnaile;1;1;2;3375913.3;assembly;all
435;Asite * relA * trnaleu;1;1;2;3377377.4;assembly;all
427;Asite * relA * trnahis;1;1;2;3378368.8;assembly;all
453;Asite * relA * trnatyr;1;1;2;3378368.8;assembly;all
445;Asite * relA * trnaser;1;1;2;3380132.9;assembly;all
457;90S;1;1;2;6557280;assembly;all
48;Esite * Psite * mRNAcodoncys * trnacys;8;3;11;6559072.1;assembly;all
52;Esite * Psite * mRNAcodongly * trnagly;8;3;11;6559228.1;assembly;all
60;Esite * Psite * mRNAcodongln * trnagln;8;3;11;6559354;assembly;all
55;Esite * Psite * mRNAcodonlys * trnalys;8;3;11;6559671.4;assembly;all
50;Esite * Psite * mRNAcodonglu * trnaglu;8;3;11;6559671.5;assembly;all
63;Esite * Psite * mRNAcodonthr * trnathr;8;3;11;6559716.5;assembly;all
58;Esite * Psite * mRNAcodonasn * trnaasn;8;3;11;6559726.4;assembly;all
65;Esite * Psite * mRNAcodontrp * trnatrp;8;3;11;6559755.5;assembly;all
64;Esite * Psite * mRNAcodonval * trnaval;8;3;11;6559776.5;assembly;all
51;Esite * Psite * mRNAcodonphe * trnaphe;8;3;11;6559778;assembly;all
47;Esite * Psite * mRNAcodonala * trnaala;8;3;11;6559817.5;assembly;all
61;Esite * Psite * mRNAcodonarg * trnaarg;8;3;11;6560082.7;assembly;all
56;Esite * Psite * mRNAcodonmet * trnamet;8;3;11;6560095.7;assembly;all
49;Esite * Psite * mRNAcodonasp * trnaasp;8;3;11;6560108.6;assembly;all
59;Esite * Psite * mRNAcodonpro * trnapro;8;3;11;6560139.7;assembly;all
54;Esite * Psite * mRNAcodonile * trnaile;8;3;11;6560148.7;assembly;all
57;Esite * Psite * mRNAcodonleu * trnaleu;8;3;11;6561612.8;assembly;all
53;Esite * Psite * mRNAcodonhis * trnahis;8;3;11;6562604.2;assembly;all
66;Esite * Psite * mRNAcodontyr * trnatyr;12;7;19;6562604.2;assembly;all
62;Esite * Psite * mRNAcodonser * trnaser;8;3;11;6564368.3;assembly;all
459;100S;1;1;2;6570720;assembly;all
1928;3ocddec5eACP;1;1;2;;metabolite;all
1929;3hcddec5eACP;1;1;2;;metabolite;all
1932;3ocmrs7eACP;1;1;2;;metabolite;all
1933;3hcmrs7eACP;1;1;2;;metabolite;all
1936;3ocpalm9eACP;1;1;2;;metabolite;all
1937;3hcpalm9eACP;1;1;2;;metabolite;all
1938;3ooctdACP;1;1;2;;metabolite;all
1940;3ocvac11eACP;1;1;2;;metabolite;all
1941;3hcvac11eACP;1;1;2;;metabolite;all
1963;14glucan;1;3;4;;metabolite;all
1974;2dhguln;1;2;3;;metabolite;all
1993;3hodcoa;0;2;2;;metabolite;all
1999;2dmmq8;5;6;11;;metabolite;all
2001;2dmmql8;7;6;13;;metabolite;all
2027;but;2;1;3;;metabolite;all
2032;hxcoa;3;2;5;;metabolite;all
2048;ppa;4;1;5;;metabolite;all
2075;frulysp;1;1;2;;metabolite;all
2080;ggptrc;1;1;2;;metabolite;all
2090;dcaACP;3;2;5;;metabolite;all
2092;ddcaACP;3;5;8;;metabolite;all
2093;t3c5ddeceACP;1;2;3;;metabolite;all
2094;cddec5eACP;2;1;3;;metabolite;all
2096;myrsACP;3;6;9;;metabolite;all
2097;t3c7mrseACP;1;2;3;;metabolite;all
2098;tdeACP;3;4;7;;metabolite;all
2100;palmACP;3;4;7;;metabolite;all
2101;t3c9palmeACP;1;2;3;;metabolite;all
2102;hdeACP;3;5;8;;metabolite;all
2104;ocdcaACP;3;2;5;;metabolite;all
2105;t3c11vaceACP;1;2;3;;metabolite;all
2106;octeACP;3;2;5;;metabolite;all
2108;butACP;2;1;3;;metabolite;all
2110;hexACP;2;1;3;;metabolite;all
2112;ocACP;3;2;5;;metabolite;all
2122;cechddd;1;1;2;;metabolite;all
2134;dcacoa;2;2;4;;metabolite;all
2148;fuc-L;1;1;2;;metabolite;all
2166;mqn8;10;12;22;;metabolite;all
2167;mql8;13;10;23;;metabolite;all
2169;q8h2;17;6;23;;metabolite;all
2174;op4en;2;1;3;;metabolite;all
2177;malthp;1;2;3;;metabolite;all
2178;maltpt;4;3;7;;metabolite;all
2182;melib;1;2;3;;metabolite;all
2202;malACP;1;14;15;;metabolite;all
2206;psclys;1;1;2;;metabolite;all
2211;cdec3eACP;1;1;2;;metabolite;all
2254;progly;1;1;2;;metabolite;all
2287;4ampm;3;1;4;;metabolite;all
2296;2ombzl;2;1;3;;metabolite;all
2297;2ommbl;1;2;3;;metabolite;all
2298;2omhmbl;2;1;3;;metabolite;all
2336;dhmptp;1;0;1;;metabolite;all
2337;air;1;2;3;;metabolite;all
2339;ssaltpp;1;1;2;;metabolite;all
2348;apoACP;0;1;1;;metabolite;all
2351;cbi;1;1;2;;metabolite;all
2372;kdo;1;1;2;;metabolite;all
2378;thm;1;1;2;;metabolite;all
2386;5drib;1;1;2;;metabolite;all
2406;udcpdp;11;2;13;;metabolite;all
2426;grxrd;1;5;6;;metabolite;all
2427;grxox;5;1;6;;metabolite;all
2433;pe161;2;5;7;;metabolite;all
2434;cpe160;1;0;1;;metabolite;all
2435;pe181;2;5;7;;metabolite;all
2436;cpe180;1;0;1;;metabolite;all
2437;pg161;4;7;11;;metabolite;all
2438;cpg160;1;0;1;;metabolite;all
2439;pg181;4;7;11;;metabolite;all
2440;cpg180;1;0;1;;metabolite;all
2441;12dgr120;3;1;4;;metabolite;all
2442;pa120;4;6;10;;metabolite;all
2443;12dgr140;3;1;4;;metabolite;all
2444;pa140;4;6;10;;metabolite;all
2445;12dgr141;3;1;4;;metabolite;all
2446;pa141;4;6;10;;metabolite;all
2447;12dgr160;3;1;4;;metabolite;all
2448;pa160;4;6;10;;metabolite;all
2449;12dgr161;4;1;5;;metabolite;all
2450;pa161;4;6;10;;metabolite;all
2451;12dgr180;3;1;4;;metabolite;all
2452;pa180;4;6;10;;metabolite;all
2453;12dgr181;4;1;5;;metabolite;all
2454;pa181;4;6;10;;metabolite;all
2455;1ddecg3p;2;2;4;;metabolite;all
2456;1hdec9eg3p;2;2;4;;metabolite;all
2457;1hdecg3p;2;2;4;;metabolite;all
2458;1odec11eg3p;2;2;4;;metabolite;all
2459;1odecg3p;2;2;4;;metabolite;all
2460;1tdec7eg3p;2;2;4;;metabolite;all
2461;1tdecg3p;2;2;4;;metabolite;all
2462;2agpe120;2;3;5;;metabolite;all
2463;ddca;14;3;17;;metabolite;all
2464;pe120;2;3;5;;metabolite;all
2465;dca;2;1;3;;metabolite;all
2466;ttdca;14;3;17;;metabolite;all
2467;ttdcea;14;3;17;;metabolite;all
2469;hdcea;14;3;17;;metabolite;all
2472;pg120;4;6;10;;metabolite;all
2473;apg120;2;0;2;;metabolite;all
2474;2agpe140;2;3;5;;metabolite;all
2475;pe140;2;3;5;;metabolite;all
2476;pg140;4;6;10;;metabolite;all
2477;apg140;2;0;2;;metabolite;all
2478;2agpe141;2;3;5;;metabolite;all
2479;pe141;2;3;5;;metabolite;all
2480;pg141;4;6;10;;metabolite;all
2481;apg141;2;0;2;;metabolite;all
2482;2agpe160;3;3;6;;metabolite;all
2483;pe160;2;4;6;;metabolite;all
2486;pg160;4;7;11;;metabolite;all
2487;apg160;2;0;2;;metabolite;all
2488;2agpe161;2;3;5;;metabolite;all
2489;apg161;2;0;2;;metabolite;all
2490;2agpe180;2;3;5;;metabolite;all
2492;pe180;2;3;5;;metabolite;all
2493;pg180;4;6;10;;metabolite;all
2494;apg180;2;0;2;;metabolite;all
2495;2agpe181;2;3;5;;metabolite;all
2497;apg181;2;0;2;;metabolite;all
2498;2agpg120;2;3;5;;metabolite;all
2500;2agpg140;2;3;5;;metabolite;all
2501;2agpg141;2;3;5;;metabolite;all
2502;2agpg160;3;3;6;;metabolite;all
2503;2agpg161;2;3;5;;metabolite;all
2504;2agpg180;2;3;5;;metabolite;all
2506;2agpg181;2;3;5;;metabolite;all
2507;2ddecg3p;2;1;3;;metabolite;all
2508;2hdec9eg3p;2;1;3;;metabolite;all
2509;2hdecg3p;2;1;3;;metabolite;all
2510;2odec11eg3p;2;1;3;;metabolite;all
2511;2odecg3p;2;1;3;;metabolite;all
2512;2tdec7eg3p;2;1;3;;metabolite;all
2513;2tdecg3p;2;1;3;;metabolite;all
2516;cdpdddecg;1;3;4;;metabolite;all
2517;pgp120;1;3;4;;metabolite;all
2518;ps120;1;1;2;;metabolite;all
2519;cdpdhdec9eg;1;3;4;;metabolite;all
2520;pgp161;1;3;4;;metabolite;all
2521;ps161;1;1;2;;metabolite;all
2522;cdpdhdecg;1;3;4;;metabolite;all
2523;pgp160;1;3;4;;metabolite;all
2524;ps160;1;1;2;;metabolite;all
2525;cdpdodec11eg;1;3;4;;metabolite;all
2526;pgp181;1;3;4;;metabolite;all
2527;ps181;1;1;2;;metabolite;all
2528;cdpdodecg;1;3;4;;metabolite;all
2529;pgp180;1;3;4;;metabolite;all
2530;ps180;1;1;2;;metabolite;all
2531;cdpdtdec7eg;1;3;4;;metabolite;all
2532;pgp141;1;3;4;;metabolite;all
2533;ps141;1;1;2;;metabolite;all
2534;cdpdtdecg;1;3;4;;metabolite;all
2535;pgp140;1;3;4;;metabolite;all
2536;ps140;1;1;2;;metabolite;all
2541;g3ps;1;2;3;;metabolite;all
2557;bglycogen;1;2;3;;metabolite;all
2573;hmfurn;1;1;2;;metabolite;all
2583;murein5p5p[p];1;1;2;;metabolite;all
2584;murein5p5p5p[p];1;0;1;;metabolite;all
2587;anhgm;5;1;6;;metabolite;all
2588;anhm;3;1;4;;metabolite;all
2589;anhgm3p;5;3;8;;metabolite;all
2590;anhm3p;2;1;3;;metabolite;all
2591;LalaDgluMdap;6;2;8;;metabolite;all
2592;anhgm4p;4;5;9;;metabolite;all
2593;anhm4p;1;2;3;;metabolite;all
2594;LalaDgluMdapDala;4;3;7;;metabolite;all
2595;um4p;1;1;2;;metabolite;all
2596;ugmd;3;1;4;;metabolite;all
2600;anhgm[p];1;1;2;;metabolite;all
2602;anhgm3p[p];0;1;1;;metabolite;all
2603;anhgm4p[p];0;1;1;;metabolite;all
2604;LalaDgluMdap[p];1;1;2;;metabolite;all
2605;LalaDgluMdapDala[p];1;1;2;;metabolite;all
2638;fldrd;1;4;5;;metabolite;all
2639;fldox;4;1;5;;metabolite;all
2656;hdcoa;1;2;3;;metabolite;all
2657;odecoa;1;2;3;;metabolite;all
2658;tdecoa;1;2;3;;metabolite;all
2668;dca[p];1;1;2;;metabolite;all
2669;ddca[p];1;1;2;;metabolite;all
2670;ttdca[p];1;1;2;;metabolite;all
2671;ttdcea[p];1;1;2;;metabolite;all
2673;hdcea[p];1;1;2;;metabolite;all
2690;crnDcoa;2;0;2;;metabolite;all
2693;12dgr120[p];0;1;1;;metabolite;all
2694;12dgr140[p];0;1;1;;metabolite;all
2695;12dgr141[p];0;1;1;;metabolite;all
2696;12dgr160[p];0;1;1;;metabolite;all
2697;12dgr161[p];0;1;1;;metabolite;all
2698;12dgr180[p];0;1;1;;metabolite;all
2699;12dgr181[p];0;1;1;;metabolite;all
2704;14glucan[p];1;1;2;;metabolite;all
2705;14glucan[e];0;1;1;;metabolite;all
2718;2ddecg3p[p];0;1;1;;metabolite;all
2719;2tdecg3p[p];0;1;1;;metabolite;all
2720;2tdec7eg3p[p];0;1;1;;metabolite;all
2721;2hdecg3p[p];0;1;1;;metabolite;all
2722;2hdec9eg3p[p];0;1;1;;metabolite;all
2723;2odecg3p[p];0;1;1;;metabolite;all
2724;2odec11eg3p[p];0;1;1;;metabolite;all
2725;2agpe120[p];0;1;1;;metabolite;all
2726;2agpe140[p];0;1;1;;metabolite;all
2727;2agpe141[p];0;1;1;;metabolite;all
2728;2agpe160[p];0;1;1;;metabolite;all
2729;2agpe161[p];0;1;1;;metabolite;all
2730;2agpe180[p];0;1;1;;metabolite;all
2731;2agpe181[p];0;1;1;;metabolite;all
2732;2agpg120[p];0;1;1;;metabolite;all
2733;2agpg140[p];0;1;1;;metabolite;all
2734;2agpg141[p];0;1;1;;metabolite;all
2735;2agpg160[p];0;1;1;;metabolite;all
2736;2agpg161[p];0;1;1;;metabolite;all
2737;2agpg180[p];0;1;1;;metabolite;all
2738;2agpg181[p];0;1;1;;metabolite;all
2749;LalaDgluMdap[e];0;1;1;;metabolite;all
2754;LalaDgluMdapDala[e];0;1;1;;metabolite;all
2759;unagamuf;1;4;5;;metabolite;all
2786;acolipa[p];0;1;1;;metabolite;all
2787;acolipa[e];1;0;1;;metabolite;all
2823;fpram;1;1;2;;metabolite;all
2835;anhgm[e];0;1;1;;metabolite;all
2841;arbtn;3;2;5;;metabolite;all
2842;arbtn[p];1;1;2;;metabolite;all
2843;arbtn[e];1;0;1;;metabolite;all
2864;butso3[p];1;1;2;;metabolite;all
2865;butso3;1;1;2;;metabolite;all
2866;butso3[e];0;1;1;;metabolite;all
2867;but[p];1;1;2;;metabolite;all
2868;but[e];0;1;1;;metabolite;all
2875;cbi[e];0;1;1;;metabolite;all
2876;cbi[p];1;1;2;;metabolite;all
2893;lipa_cold[p];1;1;2;;metabolite;all
2894;lipa_cold[e];1;0;1;;metabolite;all
2909;colipa;1;5;6;;metabolite;all
2910;colipa[p];1;1;2;;metabolite;all
2911;colipa[e];1;0;1;;metabolite;all
2912;cpgn[p];1;1;2;;metabolite;all
2913;cpgn;2;3;5;;metabolite;all
2914;cpgn-un;3;2;5;;metabolite;all
2915;cpgn[e];0;1;1;;metabolite;all
2916;cpgn-un[p];1;1;2;;metabolite;all
2917;cpgn-un[e];1;0;1;;metabolite;all
2927;cu;0;3;3;;metabolite;all
2928;cu[p];2;0;2;;metabolite;all
2932;cu[e];1;1;2;;metabolite;all
2942;trnasecys;0;1;1;;metabolite;all
2955;dca[e];0;1;1;;metabolite;all
2960;ddca[e];0;1;1;;metabolite;all
2999;dsbdox;2;1;3;;metabolite;all
3000;dsbdrd;1;2;3;;metabolite;all
3010;dsbard[p];0;2;2;;metabolite;all
3011;dsbaox[p];2;0;2;;metabolite;all
3012;;8;0;8;;metabolite;all
3013;eca4colipa[p];0;1;1;;metabolite;all
3014;eca4colipa[e];1;0;1;;metabolite;all
3015;eca4und;1;1;2;;metabolite;all
3016;eca4colipa;1;0;1;;metabolite;all
3017;eca2und;1;1;2;;metabolite;all
3018;eca3und;1;1;2;;metabolite;all
3019;unagamuf[p];1;0;1;;metabolite;all
3023;kdo2lipid4p;1;1;2;;metabolite;all
3024;lipa_cold;1;1;2;;metabolite;all
3030;ethso3[p];1;1;2;;metabolite;all
3031;ethso3;1;1;2;;metabolite;all
3032;ethso3[e];0;1;1;;metabolite;all
3035;clpn120;1;1;2;;metabolite;all
3036;clpn140;1;1;2;;metabolite;all
3037;clpn141;1;1;2;;metabolite;all
3038;clpn160;1;1;2;;metabolite;all
3042;clpn161;1;1;2;;metabolite;all
3043;clpn180;1;1;2;;metabolite;all
3044;clpn181;1;1;2;;metabolite;all
3056;fe3dhbzs;1;1;2;;metabolite;all
3057;fe3dhbzs[p];1;1;2;;metabolite;all
3058;fe3dhbzs[e];0;1;1;;metabolite;all
3061;fe3hox-un;3;2;5;;metabolite;all
3063;fe3hox-un[p];1;1;2;;metabolite;all
3064;fe3hox-un[e];1;0;1;;metabolite;all
3068;fecrm-un;3;2;5;;metabolite;all
3070;fecrm-un[p];1;1;2;;metabolite;all
3071;fecrm-un[e];1;0;1;;metabolite;all
3078;feoxam-un;3;2;5;;metabolite;all
3080;feoxam-un[p];1;1;2;;metabolite;all
3081;feoxam-un[e];1;0;1;;metabolite;all
3082;1agpe120;1;1;2;;metabolite;all
3083;1agpe140;1;1;2;;metabolite;all
3084;1agpe141;1;1;2;;metabolite;all
3086;1agpe160;1;1;2;;metabolite;all
3087;1agpe161;1;1;2;;metabolite;all
3095;fuc-L[e];0;1;1;;metabolite;all
3096;fuc-L[p];1;1;2;;metabolite;all
3101;1agpe181;1;1;2;;metabolite;all
3110;g3ps[p];1;1;2;;metabolite;all
3111;g3ps[e];0;1;1;;metabolite;all
3112;1agpg120;1;1;2;;metabolite;all
3113;1agpg140;1;1;2;;metabolite;all
3121;1agpg141;1;1;2;;metabolite;all
3128;gicolipa;1;1;2;;metabolite;all
3129;gagicolipa;1;1;2;;metabolite;all
3139;1agpg160;1;1;2;;metabolite;all
3141;gdpofuc;1;1;2;;metabolite;all
3142;1agpg161;1;1;2;;metabolite;all
3145;1agpg180;1;1;2;;metabolite;all
3146;1agpg181;1;1;2;;metabolite;all
3151;icolipa;1;1;2;;metabolite;all
3152;ggagicolipa;1;1;2;;metabolite;all
3153;gggagicolipa;1;1;2;;metabolite;all
3188;gmhep17bp;1;1;2;;metabolite;all
3204;alpp;0;2;2;;metabolite;all
3205;lpp;2;0;2;;metabolite;all
3216;hdcea[e];0;1;1;;metabolite;all
3217;hhlipa;1;1;2;;metabolite;all
3218;phhlipa;1;1;2;;metabolite;all
3219;hphhlipa;1;1;2;;metabolite;all
3220;phphhlipa;1;1;2;;metabolite;all
3221;hlipa;1;1;2;;metabolite;all
3253;uLa4n;1;2;3;;metabolite;all
3254;acolipa;1;0;1;;metabolite;all
3260;hacolipa;1;0;1;;metabolite;all
3261;halipa;1;0;1;;metabolite;all
3267;dsbcox;0;1;1;;metabolite;all
3268;dsbcrd;1;0;1;;metabolite;all
3269;dsbgox;0;1;1;;metabolite;all
3270;dsbgrd;1;0;1;;metabolite;all
3284;maltpt[p];1;1;2;;metabolite;all
3286;maltpt[e];0;1;1;;metabolite;all
3298;murein3px3p;1;1;2;;metabolite;all
3299;murein3p3p;2;1;3;;metabolite;all
3300;murein3px4p;1;1;2;;metabolite;all
3301;murein4p3p;3;2;5;;metabolite;all
3302;murein4p4p;2;2;4;;metabolite;all
3303;murein4px4p;2;1;3;;metabolite;all
3304;murein4px4px4p;1;1;2;;metabolite;all
3305;murein4px4p4p;1;1;2;;metabolite;all
3306;melib[p];2;1;3;;metabolite;all
3307;melib[e];0;1;1;;metabolite;all
3308;murein5p3p;2;1;3;;metabolite;all
3313;murein5p4p;2;1;3;;metabolite;all
3314;murein5p5p;0;4;4;;metabolite;all
3325;murein5px3p;1;2;3;;metabolite;all
3326;murein5px4p;1;3;4;;metabolite;all
3327;murein5px4px4p;1;1;2;;metabolite;all
3339;kphphhlipa;1;1;2;;metabolite;all
3359;o16a4colipa[p];0;1;1;;metabolite;all
3360;o16a4colipa[e];1;0;1;;metabolite;all
3361;o16a4und;1;1;2;;metabolite;all
3362;o16a4colipa;1;0;1;;metabolite;all
3363;o16aund;1;4;5;;metabolite;all
3364;o16a2und;1;1;2;;metabolite;all
3365;o16a3und;1;1;2;;metabolite;all
3366;ragund;0;1;1;;metabolite;all
3367;aragund;1;1;2;;metabolite;all
3368;o16aund[p];1;0;1;;metabolite;all
3369;garagund;1;1;2;;metabolite;all
3370;gfgaragund;1;1;2;;metabolite;all
3381;pa120[p];1;0;1;;metabolite;all
3382;pa140[p];1;0;1;;metabolite;all
3383;pa141[p];1;0;1;;metabolite;all
3384;pa160[p];1;0;1;;metabolite;all
3385;pa161[p];1;0;1;;metabolite;all
3386;pa180[p];1;0;1;;metabolite;all
3387;pa181[p];1;0;1;;metabolite;all
3390;pe120[p];1;0;1;;metabolite;all
3391;pe140[p];1;0;1;;metabolite;all
3392;pe141[p];1;0;1;;metabolite;all
3393;pe160[p];1;0;1;;metabolite;all
3394;pe161[p];1;0;1;;metabolite;all
3395;pe180[p];1;0;1;;metabolite;all
3396;pe181[p];1;0;1;;metabolite;all
3400;pg120[p];1;0;1;;metabolite;all
3401;pg140[p];1;0;1;;metabolite;all
3402;pg141[p];1;0;1;;metabolite;all
3403;pg160[p];1;0;1;;metabolite;all
3404;pg161[p];1;0;1;;metabolite;all
3405;pg180[p];1;0;1;;metabolite;all
3406;pg181[p];1;0;1;;metabolite;all
3407;pgp120[p];1;0;1;;metabolite;all
3408;pgp140[p];1;0;1;;metabolite;all
3409;pgp141[p];1;0;1;;metabolite;all
3410;pgp160[p];1;0;1;;metabolite;all
3411;pgp161[p];1;0;1;;metabolite;all
3412;pgp180[p];1;0;1;;metabolite;all
3413;pgp181[p];1;0;1;;metabolite;all
3423;ppa[p];1;1;2;;metabolite;all
3424;ppa[e];0;1;1;;metabolite;all
3430;progly[p];1;1;2;;metabolite;all
3431;progly[e];0;1;1;;metabolite;all
3433;psclys[p];1;1;2;;metabolite;all
3434;psclys[e];0;1;1;;metabolite;all
3455;murein5p5p5p;0;1;1;;metabolite;all
3482;dsbcox[p];0;1;1;;metabolite;all
3483;dsbcrd[p];1;0;1;;metabolite;all
3484;dsbgox[p];0;1;1;;metabolite;all
3485;dsbgrd[p];1;0;1;;metabolite;all
3488;thm[p];1;1;2;;metabolite;all
3491;thm[e];0;1;1;;metabolite;all
3509;ttdca[e];0;1;1;;metabolite;all
3510;ttdcea[e];0;1;1;;metabolite;all
3535;uLa4n[p];1;0;1;;metabolite;all
3538;uLa4fn;1;1;2;;metabolite;all